AACTAY	aechtie
AALTJ	aeltje
AAMYNA	aamina
AARVN	aaron
ABA	aba
ABAD	abad
ABADA	obadja
ABADHBY	abudhabi
ABAJA	obadja
ABAR	aabar
ABCR	abcher
ABDJA	obadja
ABDLRHMAN	abdalrahman
ABDVN	ebdon
ABH	abe
ABHAY	abhay
ABHY	abhay
ABLA	abella
ABL	abel
ABL	abell
ABLH	abele
ABLHYD	adelheid
ABLJ	abeltje
ABLT	abeltje
ABLTJ	abeltje
ABLY	abley
ABLYSN	ablation
ABND	abend
ABNR	abner
'ABR	aabar
ABR	aabar
ABRAHAM	abraham
ABRAHYM	ebrahim
ABRAHYM	ibrahim
ABRAM	abram
ABRAMSVN	abramson
ABRAPT	abrupt
ABRAYT	ebright
ABRBAC	eberbach
ABRG	aberg
ABRG	oborg
ABRKRVMBY	abercrombie
ABRL	oberle
ABRLY	eberle
ABRMSKY	obremski
ABRT	ebbert
ABRT	ebert
ABRVTR	oberreuter
ABRY	abery
ABRY	aubrey
ABRYN	obrien
ABRYNY	ibrini
ABSTGARTN	obstgarten
ABST	obst
ABSTRKT	abstract
ABT	abbott
ABTYN	abtine
ABV	abou
ABVBA	aboba
ABVDBY	abudhabi
ABVDHABY	abudhabi
ABVHBYB	abudhabi
ABVLYN	abolin
ABVRYMH	eboreime
ABVT	abbot
ABVT	abbott
ABVTSMYT	abbotsmith
ABYA	abia
ABYAB	abiab
ABY	abbey
ABY	abby
ABYAD	abiad
ABYAN	abyan
ABYD	ubaid
ABY	ebe
ABYL	abel
ABYLAK	abilock
ABYNA	ebina
ABYNGM	obbingem
ABYNGN	obbingem
ACDL	archdale
AC	ech
ACR	archer
ACRNAR	achernar
ACTY	aechtie
ACTYH	aechtie
ACY	aechtie
ACYLS	achilles
ACYSVN	atchison
ACYT	aechtie
ADAB	adab
ADAM	adam
ADAMV	adamo
ADANA	adana
ADAN	adan
ADANL	odonnell
ADARA	edara
ADB	adab
ADBRG	edberg
ADGRYNGLND	adgeringelant
ADGRYNGLNT	adgeringelant
ADGYNGTVN	edgington
ADH	ade
ADKAK	adcock
ADKK	adcock
ADKRYK	oudekirk
ADKVK	adcock
ADKYNZ	adkins
ADKYRK	oudekirk
ADLA	adela
'ADL	adel
ADL	adel
ADLARDV	adelardo
ADLAYD	adelaide
ADLAYD	adelheid
ADLHYD	adelheid
ADLMA	adalma
ADL	odell
ADLR	adler
ADLSVN	adelson
ADLY	audley
ADMVND	edmonds
ADMVNDS	edmonds
ADMVNDZ	edmonds
ADMVNZ	edmonds
ADMYRALN	admiralen
ADMYRALZ	admirals
ADMYSTVN	edmiston
ADNAMS	adnams
ADNAMZ	adnams
ADNBRAG	edenborough
ADNBRG	edenborough
ADNBRV	edenborough
ADNBRVG	edenborough
ADNBVRG	edenborough
ADRY	adri
ADRY	adrie
ADRYANA	adriana
ADRYAN	adriaen
ADRYANS	adriance
ADRYN	adriane
ADRYNKLNT	adgeringelant
ADRYNS	adriance
ADRYNY	adriene
ADRYNY	adrienne
ADRYS	idris
ADSAL	edsall
ADST	adsett
ADSVN	eidsson
ADT	adsett
ADVARD	edvard
ADVARD	edward
ADVARDSN	edwardsson
ADVART	eduwart
ADVLF	adolph
ADVLFSVN	adolfsson
ADVLF	udolph
ADVNCR	adventure
ADVNL	odonnell
ADVNYS	adonis
ADVSVMALY	adusumalli
ADVVART	eduwart
ADY	addy
ADY	athey
ADY	eadie
ADY	eady
ADY	eddey
ADYH	adie
ADYK	adik
ADYKS	addicks
'ADYL	adil
ADYL	adil
ADYLRD	ethilrede
ADYNA	adina
ADYNGTVN	addington
ADYNGTVN	edgington
ADYS	addis
ADYSAK	adisak
ADYSVN	addison
ADYT	adit
AFA	afa
AFAF	afaf
AFRA	afra
AFRDYT	aphrodite
AFRVDYT	aphrodite
AFTAB	aftab
AFV	afou
AFVRYL	aphoriel
AFYCART	aphichart
AFYF	afif
AFYGTN	uffington
AFYNGTN	uffington
AFYS	office
AFYSR	officer
AFYVN	afioun
AFZAL	afzal
AFZL	afzal
AGALY	agali
AGAS	agass
AGATY	agate
AGBRN	ogborn
AGBVRN	ogborn
AG	egg
AGLSTVN	eaglestone
AGMN	eggeman
AGMVZ	egmose
AGNDY	agndie
AGNV	ageno
AGNVYK	aganovic
AGPYAN	agopian
AGR	augor
AGRAVALA	agrawala
AGRN	agren
AGRTN	egerton
AGRTVN	egerton
AGRYNGLANT	adgeringelant
AGRYNGLND	adgeringelant
AGVLV	agullo
AGVR	augor
AGVSTV	augusto
AGVSTYN	augustyn
AGVSTYNLY	agostinelli
AGVSTYNY	agostini
AGVYRV	aguero
AGVYV	agoyo
AGYLA	aqila
AGYL	aqil
AGYLSVN	egilsson
AGYNST	against
AHAY	aahie
AHLAND	ohlund
AHMAN	ohmann
AHMN	ohman
AHRN	ahern
AHY	aahie
AHYH	aahie
AJ	aetje
AJAST	ojaste
AJAY	ajay
AJDA	ojeda
AJLVS	aggelos
AJNT	agent
AJRAYNGLND	adgeringelant
AJYNGTVN	eggington
AJYNTVN	edginton
AKA	aka
AK	ack
AKADMY	academy
AKADMYK	akademik
AKAKS	acox
AKAPADY	accapadi
AKBRG	ekberg
AKBVRN	ayckbourn
AKDAG	akdag
AK	eck
AKGAN	akgun
AKL	akl
AKLAND	eklund
AKLND	auckland
AKLVF	eklof
AKLY	ackley
AKLY	oakley
AKM	akeem
AKMAN	akman
AKMANDNSYS	ekmundensis
AKMANDSYS	ekmundensis
AKMAN	ekman
AKMNA	acmena
AKMN	ekman
AKMR	alcmere
AKMVNDNSYS	ekmundensis
AKMY	akemi
AKN	akeem
AK	oke
AKR	ecker
AKRM	ackerman
AKRMAN	ackerman
AKRMN	ackerman
AKRSAND	eckersand
AKRSLATV	ekerslato
AKRSLYTV	ekerslato
AKRSTV	ekerslato
AKRT	eckert
AKRVYD	ackroyd
AKRYL	akrill
AKS	axe
AKSAYL	exile
AKSDLM	axthelm
AKSFRD	axford
AKSFVRD	axford
AKSFVRD	oxford
AKSKRYTYA	excretia
AKSLSVN	axelsson
AKSLY	oxley
AKSS	access
AKSTRND	ekstrand
AKSTYN	eckstein
AKSV	aksu
AKSYL	axel
AKTS	awketts
AKTVN	acton
AKTVN	eckton
AKTY	aechtie
AKTYV	active
AKVAL	ekwall
AKVAYLA	aqila
AKVAYL	aqil
AKVDV	acevedo
AKVKS	acox
AKVNA	acuna
AKVNR	acuner
AKVSTA	acosta
AKY	acee
AKY	aki
AKYF	okeefe
AKYHYKV	akihiko
AKYLA	akilah
AKYLA	aqila
AKYLAH	akilah
AKYL	akil
AKYL	aqil
AKYLH	akilah
AKYLS	akilesh
AKYM	akeem
AKYN	akin
AKYTVMV	akitomo
AL'ADYN	alaaldin
ALAHAYDYKYA	alladhiqiyah
ALAHDVD	alhudud
ALALDYN	alaaldin
AL	all
ALAM	ellam
ALAMZ	allums
ALANA	alana
ALANGKV	elangco
ALAPATY	alapati
ALAQBH	alaqabah
ALARD	allard
ALASR	aleser
ALASVRS	alsworth
ALAVAY	allaway
ALAVY	allaway
ALAYN	alain
ALAYSDYR	alaisdair
ALAYS	elyse
ALBAHAH	albahah
ALBHA	albahah
ALBHAH	albahah
ALBLJH	abeltje
ALBR	alber
ALBRAYT	albright
ALBRT	albert
ALBRTYNY	albertini
ALBRY	allbery
ALBRYJ	albright
ALBVN	labdon
ALBVZ	elbows
ALBYNGR	albinger
ALDHAYD	adelheid
ALDLHLD	adelheid
ALDN	alden
ALDN	allden
ALD	ould
ALDR	alder
ALDRD	eldred
ALDRYC	aldrich
ALDRYDJ	eldridge
ALDRYG	aldridge
ALDRYG	auldridge
ALDRYJ	aldridge
ALDRYJ	auldridge
ALDRYJ	eldridge
ALDRYJH	aldridge
ALDYN	eldin
ALDZ	olds
ALFA	alpha
ALF	alf
ALFANSV	alfonso
ALFARV	alfaro
ALF	elf
ALFRD	alfred
ALFRDV	alfredo
ALFRS	alfors
ALFRYNG	elfering
ALFVRD	alford
ALFVRD	elford
ALGADV	alegado
ALGARD	ellegaard
ALGAYN	olguin
ALGRV	allegro
ALGSAN	alagesan
ALGY	algie
ALGYNGTVN	elkington
ALHDAD	alhudud
ALHDVD	alhudud
ALJ	aeltje
ALJH	aeltje
ALKAN	elkan
ALKBAH	alaqabah
ALKBR	alkabeer
ALKBYR	alkabeer
ALKK	allcock
ALKMR	alcmere
ALKMRH	alcmere
ALKMRY	alcmere
ALKR	allcor
ALKRTN	alkerton
ALKRTVN	alkerton
ALKS	alex
ALKSANDR	alexander
ALKSANDRVZ	alexandros
ALKSNDR	alexander
ALKSY	alexy
ALKSYV	alexiou
ALKVAB	alaqabah
ALKVK	allcock
ALKVR	allcor
ALKYNGTN	elkington
ALKYNGTVN	elkington
ALKYNTN	elkinton
ALLADHKYAH	alladhiqiyah
ALLADHYKYAH	alladhiqiyah
ALLAHYGYAH	alladhiqiyah
ALLDHYKYAH	alladhiqiyah
ALLDYKYAH	alladhiqiyah
ALLHYQYH	alladhiqiyah
ALM	alm
ALMAR	elmar
ALMAS	almas
ALMATVN	olematon
ALMGRN	almgren
ALMKVAST	elmquist
ALMKVYST	almqvist
ALMN	elman
ALMNTAJ	almintaqah
ALMR	alcmere
ALMRS	elmers
ALMRVT	almeroth
ALMVD	alamode
ALMVDYVAR	almudevar
ALMV	elmo
ALMVMAN	elmoman
ALMVR	elmore
ALMYNAKAH	almintaqah
ALMYNTAGAH	almintaqah
ALMYNTAKAH	almintaqah
ALMYNTAKVA	almintaqah
ALMYNTKH	almintaqah
ALMYRAL	almirall
ALN	alden
ALN	allen
ALND	allden
ALNDR	allender
ALN	ellen
ALNVR	alnoor
ALNY	olney
ALPN	alpen
ALPRT	alpert
ALPVRT	allport
AL'QBH	alaqabah
ALRBK	ellerbeck
ALRD	allred
ALRTN	allerton
ALRTVN	allerton
ALRVY	elroy
ALRY	ellery
ALRYGH	alridge
ALRYJ	alridge
ALSANDRY	alessandri
ALSAN	olson
ALSAN	olsson
ALSAP	allsop
ALSAP	allsopp
ALSAP	alsop
ALSNDRV	alesandro
ALSN	olhsson
ALSN	olsen
ALSNR	elsner
ALSP	allsop
ALSP	alsop
ALSPD	elspeth
ALSR	aleser
ALSTRVM	ahlstrom
ALSVN	elson
ALSVN	olson
ALSVN	olsson
ALSVP	allsop
ALSVP	alsop
ALSVRS	alsworth
ALSVRT	alsworth
ALSVZ	allshouse
ALSY	elsie
ALT	aeltje
ALTANYN	eltanin
ALT	arlet
ALTAYR	altair
ALTMAN	altman
ALTMN	altman
ALTMN	oltmann
ALTRVAYD	aaltruide
ALTRVD	aaltruide
ALTRVYD	aaltruide
ALTRVYYD	aaltruide
ALTSVN	elletson
ALTV	alto
ALTYR	altair
ALTZ	oltz
ALVA	alva
ALVAN	alwan
ALVARV	alvaro
ALVARVS	alvarus
ALVARZ	alvarez
ALVAY	alleway
ALVF	elof
ALVKAL	alukal
ALVK	alok
ALVLD	eleveld
ALVRS	elvers
ALVSA	alyosha
ALVVD	ellwood
ALVVD	elwood
ALVY	allaway
ALVY	alleway
ALVYN	alvin
ALVYN	alwin
ALVYN	alwyn
ALVYN	elwin
ALVYN	elwyn
ALVYS	alwis
ALVZ	alves
ALXZNA	alkhazna
'ALYA	aaliyah
ALYA	aaliyah
'ALY	aali
A'LY	aali
ALY	aali
ALYA	alya
ALYA	elia
A'LYAH	aaliyah
ALYAH	aaliyah
ALY	allee
ALY	alley
ALY	allie
ALYAN	alain
ALYAS	alias
ALYASVN	eliason
ALYBY	alibey
ALY	elie
ALY	ely
ALYFAS	aliphas
'ALYH	aaliyah
ALYJ	arlidge
ALYKS	alyx
ALYLYVNAS	alelyunas
ALYMA	ulima
AL'YN	alain
ALYN	alain
ALYN	alien
ALYN	allyn
ALYN	elin
ALYNGR	ellinger
ALYNGTVN	alington
ALYNGTVN	elkington
ALYN	olin
ALYNYK	oleinik
ALY	olea
ALYSA	alyssa
ALYS	alias
ALYS	alice
ALYS	elyse
ALYSN	allison
ALYSTVN	elliston
ALYSTYR	alistair
ALYSVN	allison
ALYSVN	allyson
ALYSVN	elison
ALYSVN	ellison
ALYSYA	alicia
ALYVA	oliva
ALYVRYA	oliveira
ALYVT	eliot
ALYVT	elliot
ALYVY	alleway
ALYYA	elya
ALYZA	alisa
ALYZABT	elizabeth
ALYZ	allyz
ALYZR	aleser
ALZ	elz
ALZNA	alzena
ALZN	olson
ALZVRS	alsworth
AMA	ama
AMADVR	amador
AMAGYV	omaggio
A'MAL	amal
AMAL	amal
AMAND	amand
AMANVAL	emmanuel
AMANV	amano
AMANVL	emmanuel
AMANVYL	emmanuel
AMANY	amani
AMANYVL	emmanuel
AMARA	amara
AMARAL	amaral
AMARDYV	amardeo
AMARNT	amarnath
AMARYT	amarit
AMBAR	embar
AMBASY	embassy
AMBLR	ambler
AMBRLY	amberle
AMBRLY	emberley
AMBRLYNG	emberling
AMBRVSS	ambrosius
AMBRVSVS	ambrosius
AMBRVSYV	ambrosio
AMBRVSYVS	ambrosius
AMBVS	ambush
AMBYJ	ambidge
AMDYV	amedeo
AMFN	amphon
AMLAK	amlak
AML	amal
AMLK	amlak
AMLN	emlen
AMLYA	amelia
AMNA	amna
AMN	emmen
AMNVN	amnon
AMPN	ampon
AMPRVR	empereur
AMPSVN	empson
AMPT	ampte
AMPTH	ampte
AMPY	empey
AMRALD	emerald
AMR	emre
AMRJYNG	emerging
AMRMAN	amerman
AMRVSYV	ambrosio
AMRY	amery
AMRY	amory
AMRY	emery
AMRYKA	america
AMRYKN	american
AMRYKN	amerikan
AMRYTA	amritha
AMS	ems
AMSTAT	amstadt
AMSTD	umstead
AMSTR	amster
AMSY	amshey
AMT	ampte
AMTYSTA	amethysta
AMVNA	emona
AMVNDSYZ	ekmundensis
AMVRVSV	amoroso
AMVRY	amory
AMVS	amos
AMY	ami
AMY	amy
AMYH	amie
AMYHAY	amihai
AMYKVS	amicus
AMYLY	emilie
AMYLY	emily
AMYLYYV	emilio
AMYNA	aamina
AMYNA	amina
AMYNH	aamina
AMYRA	amira
AMYR	amir
AMYR	emyr
AMYT	amit
AMYTAVA	amitava
AMYT	emit
AMYT	emmett
AMYVT	amiot
AMYVT	amyot
AMYZVTA	amezquita
ANAGRAM	anagram
ANAKYN	anakin
ANALVG	analog
ANANDA	ananda
ANAND	anand
AN	anne
ANANSA	anantha
ANANT	anant
ANAS	anas
ANASTASYA	anastacia
ANATVLY	anatoly
ANATY	anathea
ANAY	anay
ANAYLYN	anilane
ANAYZA	unaiza
ANAZ	anas
ANAZA	unaiza
ANBAR	anbar
ANBR	anbar
ANBV	anbu
ANCY	anchi
ANDAMZ	adnams
AND	and
AND	ande
ANDNS	andenes
ANDRA	andra
ANDR	ander
ANDR	andr
ANDRBRG	anderberg
ANDRBVRG	enderborg
ANDRBY	enderby
ANDR	ender
ANDR	endre
ANDRR	anderer
ANDRS	andres
ANDRS	andress
ANDRSN	andersen
ANDRSN	andreasen
ANDRSVN	anderson
ANDRVS	andrus
ANDRVZ	andrews
ANDRYA	andrea
ANDRY	andree
ANDRY	andrei
ANDRYAS	andreas
ANDRYS	andres
ANDRYS	andries
ANDRYS	andris
ANDRYSN	andreassen
ANDRYSN	andreessen
ANDRYVZ	andrews
ANDRYYA	andreaea
ANDRYZ	andries
ANDSVRS	endesworth
ANDSVRT	endesworth
ANDSVVRT	endesworth
ANDVLSN	andolsen
ANDYSL	anthistle
ANDYYVRANS	endurance
ANFANT	enfant
ANFYLD	enfield
ANGBRTSN	engebretsen
ANGH	anghe
ANGLAND	englund
ANGLANDR	englander
ANGLASMA	engelsma
ANGLHARD	engelhardt
ANGLHLM	engelholm
ANGLHVRN	engelhorn
ANGLND	england
ANGLS	angles
ANGLS	engels
ANGLSMA	engelsma
ANGLSVN	engelson
ANGLTH	engeltje
ANGLTJ	engeltje
ANGLTJH	engeltje
ANGLYNA	engelina
ANGLYS	english
ANGLZ	engels
ANGRSVL	ingresole
ANGVLV	angulo
ANH	anne
ANHLD	anhold
ANJBRTSVN	engebretson
ANJL	angle
ANJLJY	engeltje
ANJLS	angeles
ANJLT	engeltje
ANJLTJA	engeltje
ANJLV	angelo
ANJLYNA	engelina
ANJLYS	angelis
ANJLYSYA	anglesea
ANJY	engi
ANJYLYNY	angelini
ANKNY	ankeney
ANKR	anker
ANKRLY	enkerli
ANKSTAD	annexstad
ANKVRN	anckorn
ANPYNGKV	unpingco
ANQ	anghe
ANQH	anghe
ANRAH	unruh
ANR	oner
ANRYK	enric
ANRYKV	enrico
ANRYKYV	enrique
ANRYKYYVZ	enriquez
ANSAR	anwar
ANSKAMB	anscomb
ANSL	ansell
ANSLM	anselm
ANSLMV	anselmo
ANSLY	ansley
ANSLYN	ansselin
ANSPAC	anspach
ANSR	anwer
ANSTYTV	institut
ANSY	anssi
ANSY	anthea
ANSYH	anisa
ANSYKR	unsicker
ANTAL	antal
ANTANAYTYS	antanaitis
ANTARAMYAN	antaramian
ANT	enete
ANTH	annette
ANTNA	antenna
ANTRAPY	entropy
ANTRV	antero
ANTRVSYV	antrosio
ANTRYKYN	entrikin
ANTSTL	anthistle
ANTSYTL	anthistle
ANTVN	anthon
ANTVN	antone
ANTVN	antoun
ANTVNVGLV	antonoglou
ANTVNVVYC	antonowich
ANTVNY	anthony
ANTVNY	antoni
ANTVNY	antony
ANTVNYS	antonis
ANTVNYS	antonius
ANTVNYV	antonio
ANTVNYVS	antonius
ANTVS	antevs
ANTY	antti
ANTYLA	antila
ANTYPDS	antipodes
ANTYSTL	anthistle
ANTYSTLH	anthistle
ANV	anno
ANV	anu
ANVAR	anwar
ANVCYN	anuchin
ANV	enno
ANV	eno
ANVJYT	anujit
ANVKVL	anukul
ANVN	anon
ANVPAM	anupam
ANVP	anoop
ANVR	anwar
ANVR	anwer
ANVR	honnur
ANVRS	anvers
ANVS	anoosh
ANVS	enos
ANVTYYADYS	enotiadis
ANVVY	envoy
ANYART	enyart
ANYJMA	enigma
ANYL	anil
ANYL	oneal
ANYL	oneill
ANYMA	aamina
ANYNG	enying
ANYSA	anisa
ANYS	ennis
ANYSH	anisa
ANYSTYN	einstein
ANYVRSRY	anniversary
ANYVS	annius
ANYYV	enyo
ANZALVNY	anzalone
ANZLVAR	anzlovar
ANZYNGR	enzinger
APCRC	upchurch
AP	epp
APL	apel
APL	appel
APLBAY	appleby
APLBRG	appelberg
APLBY	applebee
APLBY	appleby
APLMN	appleman
APLNDS	uplands
APLYBY	applebee
APLYBY	appleby
APLYN	aplin
APNDYS	apendice
APRAYT	upright
APRLY	epperly
APRSVN	aperson
APRYL	april
APSTN	upston
APSTVN	upston
APSTYN	epshteyn
APSYLVN	epsilon
APVNTH	aponte
APVRVA	apoorva
APYDAL	oppedal
APYSTYN	eppstein
AQBAL	ikbal
ARAM	oram
ARAND	aurand
ARAN	eran
ARARKH	orourke
ARAS	arras
ARAS	erach
ARASMVS	erasmus
ARAY	airay
ARAYZ	aries
ARBANAS	arbanas
ARBR	arber
ARBVR	arbur
ARBYD	irbid
ARBY	ereby
ARBYL	arbil
ARBY	orbi
ARCAL	archdale
ARCALH	archdale
ARC	arch
ARCARD	orchard
ARCDALY	archdale
ARCDL	archdale
ARCDYL	archdale
ARCR	archer
ARCYBALD	archibald
ARDALYC	ardalich
ARDMN	erdmann
ARDN	aaron
ARDRZ	arthers
ARDYS	ardis
AR	ear
ARFANAKYS	orfanakis
ARFVRD	orford
ARFYVS	orfeus
ARGAN	oregan
ARGAN	organ
ARGAR	orgar
ARHARD	erhard
ARKARD	orchard
ARKDYL	archdale
ARKTYKY	arktiki
ARLAYJ	arlidge
ARL	earl
ARL	earle
ARL	orrell
ARLT	arlet
ARLY	earley
ARLYJ	arlidge
ARLYNDH	arlidge
ARLYNG	arling
ARMAND	ormond
ARM	arm
ARMASTRANG	armstrong
ARMATV	armato
ARMNY	armeni
ARMRY	ermrey
ARMSRVNG	armstrong
ARMSTRANG	armstrong
ARMVNTRVT	armontrout
ARMVR	armour
ARMYN	eremin
ARMYTAJ	armitage
ARMYT	armitt
ARMYTAZ	armitage
ARN	aaron
ARNAT	arnot
ARND	arend
ARNDT	arendt
ARNFYLD	arnfield
ARNH	arne
ARNLD	arnold
ARNST	ernest
ARNT	arendt
ARNT	arnett
ARNT	arnot
ARNTS	arantes
ARNVLD	arnold
ARNVT	aernoudt
ARNVT	arnot
ARP	earp
ARPYN	arpin
ARS	jarash
ARSKAT	arscott
ARSKAYN	erskine
ARSNALT	arsenault
ARSY	arce
ARSYD	ersheid
ARSYKR	arsikere
ARTL	ertle
ARTR	arter
ARTRS	arthers
ARTRZ	arthers
ARTVT	aernoudt
ARTYS	artiss
ARTYZ	ortiz
ARVAL	orval
ARVMA	aromaa
ARVN	aaron
ARVNACALAM	arunachalam
ARVNAH	arunah
ARVND	aernoudt
ARVNN	eronen
ARVRKH	orourke
ARVSN	arvesen
ARVYNG	irving
ARVYVLA	arviola
ARYA	airay
ARYA	arya
ARY	ari
ARYC	erich
ARYFA	arrifa
ARYJ	alridge
ARYKA	erica
ARYKA	erika
ARYK	erick
ARYK	erik
ARYKSN	eriksen
ARYKSVN	erickson
ARYKSVN	ericson
ARYKSVN	eriksson
ARYN	erin
ARYNGTN	arrington
ARYS	aries
ARYS	ariss
ARYS	artiss
ARYSTVTL	aristotle
ARYZ	aries
ARYZ	ariss
ARZAT	arzate
ARZ	erez
ASAKVL	assakul
ASBL	asbell
ASBRN	osborne
ASBRYNK	asbrink
ASBVRN	osborne
ASCAFYLD	schofield
ASCAGN	schagen
ASCRVVYC	scherwich
ASCVFYLD	schofield
ASCVYLAR	schuyler
ASCYPLVDN	schipluiden
ASCYPLVYDN	schipluiden
ASCYPN	scheepen
ASDS	smeds
ASFAR	sphar
ASFYLD	ashfield
ASGVRYAN	asguarian
ASKADZ	scudds
ASKAGN	schagen
ASKAHAN	skahan
ASKAJN	schagen
ASKALANT	escalante
ASKAL	scull
ASKALYK	scollick
ASKALY	scally
ASKANL	scannell
ASKANYL	scannell
ASKARP	scarp
ASKARS	scarce
ASKARTSYS	skartsis
ASKARY	skari
ASK	ask
ASKATV	scotto
ASKATYA	scotia
ASKATY	scotty
ASKAVN	skaven
ASKAYA	skaya
ASKAYLR	schuyler
ASKAY	sky
ASKAYT	eskite
ASKLDSVN	eskeldson
ASKLTN	skelton
ASKLTVN	skelton
ASKLVYR	sklower
ASKNL	scannell
ASKNS	askanas
ASKP	skep
ASKRAB	scrub
ASKRANTVN	scranton
ASKRAYZ	skerries
ASKRNTN	scranton
ASKRNTVN	scranton
ASKRVYC	scherwich
ASKRYBLYNG	scribbling
ASKRYBNR	scribner
ASKRYC	screech
ASKRY	skerry
ASKRYS	scris
ASKRYV	screve
ASKVAYRL	squirrel
ASKVAYR	squire
ASKVFYLD	schofield
ASKVGAN	skogen
ASKVLY	ascoly
ASKVLYNG	scowling
ASKVLYN	scullin
ASKVLY	scully
ASKVLYZ	ascolese
ASKV	osku
ASKVRR	scorer
ASKV	sco
ASKVTVNY	scotoni
ASKVYLR	schuyler
ASKVYVYL	esquivel
ASKYBA	skiba
ASKYLS	skiles
ASKYNR	skinner
ASKYN	skean
ASKYN	skene
ASKYPLADN	schipluiden
ASKYPLVYDN	schipluiden
ASKYPN	scheepen
ASKYP	skip
ASKYPY	skippy
ASKYRS	scearce
ASKY	skee
ASKYTR	skeeter
ASLANKARD	slankard
ASLAN	slan
ASLAN	sloan
ASLAN	slone
ASLATKYN	slatkin
ASLATKYN	slotkin
ASLATR	slater
ASLATRY	slattery
ASLATVBR	slothouber
ASLAVK	slawek
ASLAVMYZ	slawomir
ASLAVNBRG	slavenburg
ASLAVYN	slavin
ASLAYK	slyke
ASLBVTNN	slabotnen
ASLD	sledd
ASLMN	asselman
ASLNGZVALD	slangsvold
ASLP	slope
ASLR	esler
ASLS	slash
ASLSYNG	slashing
ASLTN	sletten
ASLTR	slater
ASLVAN	sloan
ASLVKAM	slocum
ASLVKA	sluka
ASLVMN	sloman
ASLVN	olson
ASLVN	sloan
ASLVP	slope
ASLY	ashley
ASLYGRZ	sleegers
ASLYMAN	slimane
ASLYNY	slaney
ASLYPR	sleeper
ASLYP	sleep
ASLYTY	slate
ASLYVPAS	sliupas
ASLYV	slave
ASMA	asma
ASMADJ	smadja
ASMAL	small
ASMALY	smalley
ASMART	smart
ASMAYT	smythe
ASMDLY	smedley
ASMLN	smolen
ASMVKY	smoky
ASMVLYK	smolik
ASMVLYN	smolin
ASMVR	ashmore
ASMVT	smoot
ASMYD	smead
ASMYKLA	smikla
ASMYL	smeall
ASMYLY	smyley
ASMYRNV	smirnov
ASMYT	schmidt
ASMYTSVN	smithson
ASMYTVYK	smithwick
ASMYTZ	smiths
ASMYTZ	smits
ASNAG	snug
ASNAYDR	snyder
ASNDN	ashenden
ASNL	schnel
ASNL	snel
ASNLYNG	snelling
ASNR	eisner
ASNVDN	snowden
ASNVFYLD	snowfield
ASNVGRS	snodgrass
ASNV	snow
ASNYD	sneed
ASNYL	snail
ASNYSL	sneissel
ASPANGLR	spangler
ASPARDAM	spaarndam
ASPARKS	sparks
ASPARNDAM	spaarndam
ASPAR	spur
ASPARV	sparrow
ASPARZA	esparza
ASPATAFVRA	spatafora
ASPAT	spath
ASPATSVVD	spotswood
ASPATZ	spatz
ASPAVLDYNG	spaulding
ASPAYDR	spider
ASPAYDRZ	spiders
ASPAYK	spike
ASPAYKS	spikes
ASPAYNYNG	spinning
ASPAYRZ	spires
ASPAYZ	spies
ASPLMN	spelman
ASPLYD	spleid
ASPLYNTR	splinter
ASPNSR	spencer
ASPNS	spence
ASPRAG	sprag
ASPR	spur
ASPRVT	sproat
ASPRYBRY	sprayberry
ASPRY	sperry
ASPVLARYC	spolarich
ASPVLARYX	spolarich
ASPVR	spur
ASPVRY	sporay
ASPVSTA	spousta
ASPVSYTV	esposito
ASPVTYS	seputis
ASPYDN	speden
ASPYLMN	spillman
ASPYNAK	spinak
ASPYNDRYFT	spindrift
ASPYN	spine
ASPYRAS	spiros
ASPYR	spear
ASPYR	speer
ASPYRV	spero
ASPYRV	spiro
ASPYRYNG	spearing
ASPYRZ	spears
ASPYRZ	spiers
ASPYSAK	spisak
ASPYSYK	spacek
ASPYT	spit
ASPYTZR	spitzer
ASPYVAK	spivak
ASPZYTV	esposito
ASRAT	israt
ASRAYYL	israel
ASRMN	asherman
ASTABRT	stobert
ASTABZ	stubbs
ASTAD	stud
ASTAD	stude
ASTAFL	stoffel
ASTAFVRD	stafford
ASTAG	stagg
ASTAJANV	stajano
ASTAKMN	stockman
ASTAKR	stoker
ASTAKSLAJR	stockslager
ASTAKS	stocks
ASTAKY	stuckey
ASTAKY	stucki
ASTALKH	stolcke
ASTAMPR	stamper
ASTAM	stam
ASTANGYR	stangier
ASTANVL	estanol
ASTAPLYC	stuplich
ASTARBAK	starbuck
ASTARGS	sturges
ASTARGYL	sturgill
ASTARK	stark
ASTARKYP	starcap
ASTARKY	starkey
ASTAR	star
ASTAR	starr
ASTARTLD	startled
ASTART	start
ASTARTZ	startz
ASTARYNGR	staringer
ASTARZ	stars
ASTAS	stas
ASTATM	statham
ASTATRZ	stothers
ASTATZMN	stutzman
ASTAYLZ	styles
ASTAYNLS	stainless
ASTAYNMN	stineman
ASTAYN	stine
ASTAYR	astaire
ASTBAY	ostby
ASTCNYK	stachnik
ASTDLR	stadler
ASTDMN	stedman
ASTDYNA	stedina
ASTFANS	stephanus
ASTFAN	staffan
ASTFAN	stephane
ASTFANVS	stephanus
ASTFANV	stefano
ASTFANZ	stephanus
ASTFN	stephen
ASTFNSVN	stephenson
ASTGN	stegen
ASTK	stec
ASTLR	stoler
ASTLY	astley
ASTLYK	eastlake
ASTLY	stelly
ASTNFRD	stanford
ASTNFVRD	stanford
ASTNFVRT	stenfort
ASTNKAMB	stancomb
ASTNSL	stansell
ASTNSRAD	stensrud
ASTN	stan
ASTNTJY	steentje
ASTPKN	stepken
ASTPK	stepke
ASTRABRYJ	strawbridge
ASTRADR	strader
ASTRAKMN	struckman
ASTRAK	strock
ASTRANDR	ostrander
ASTRAP	strope
ASTR	aster
ASTRASYM	strasheim
ASTRAVB	straub
ASTRLYNG	stirling
ASTRMLR	stremler
ASTRN	austern
ASTRND	strand
ASTRN	sterne
ASTRVK	strock
ASTRVM	strum
ASTRVS	strouss
ASTRVSTRAP	stroustrup
ASTRYAN	stroyan
ASTRYBL	striebel
ASTRYD	astrid
ASTRYDM	strydom
ASTRYDR	strider
ASTRYM	stream
ASTRYN	austrian
ASTRYNGR	stringer
ASTRYNJR	stringer
ASTRYN	ostrin
ASTRYNY	strini
ASTRYR	strayer
ASTRY	stray
ASTRYTY	steriti
ASTS	estes
ASTVARD	steward
ASTVART	stewart
ASTVBRYJ	stowbridge
ASTVDVLA	stodola
ASTVFL	stoffel
ASTVKLAS	stoklas
ASTVK	stock
ASTVK	stok
ASTVKVL	stockwell
ASTVKY	stookey
ASTVLK	stolcke
ASTVLR	stoller
ASTVL	stowell
ASTVN	ashton
ASTVNBRAYJ	stonebridge
ASTVNSN	stevenson
ASTVN	stoun
ASTVN	upston
ASTVR	astore
ASTVRGA	storga
ASTVRLYR	storleer
ASTVRMZ	storms
ASTVRR	storer
ASTVRYM	sturim
ASTVRY	storey
ASTVRY	story
ASTV	stew
ASTVVAL	stovall
ASTVY	stoy
ASTYANSN	stiansen
ASTYBL	stabell
ASTYBR	stieber
ASTYD	stead
ASTYGBRG	stigberg
ASTYGMN	shtiegman
ASTYGRS	staggers
ASTYG	stig
ASTYJH	steentje
ASTYK	astik
ASTYKLMN	stickelman
ASTYLR	stealer
ASTYL	steel
ASTYL	steele
ASTYL	still
ASTYLY	stailey
ASTYLZ	stiles
ASTYN	austin
ASTYNBRG	stenberg
ASTYNSN	stinson
ASTYN	steen
ASTYN	stian
ASTYNSVN	stinson
ASTYNTH	steentje
ASTYNTJH	steentje
ASTYNTJ	steentje
ASTYNZ	staines
ASTYPLZ	staples
ASTYP	steep
ASTYRN	stearn
ASTYRNZ	stearns
ASTYSY	stacey
ASTYSY	stacy
ASTYT	stith
ASTYVDNT	student
ASTYVN	steven
ASTYVNSVN	stevenson
ASTYVS	esteves
ASTYVZ	steves
ASVALAP	aswalap
ASVALD	oswald
ASVANAY	swany
ASVK	ashok
ASVLT	stolte
ASVRS	ashworth
ASVSKY	osowski
ASVYSR	swisher
ASYA	aiesha
ASY	assi
'ASYF	asif
ASYF	asif
ASYMYLYT	assimilate
ATANSYV	atanacio
ATA	ota
ATA	otha
ATARAS	ataras
ATH	aetje
ATJH	aetje
ATKA	atka
ATKYNSN	atkinson
ATKYNSVN	atkinson
ATKYNZ	atkins
ATKYNZ	etkins
ATL	atle
ATLS	atlas
ATMSFR	atmosphere
ATMZ	atems
AT	ott
ATRAM	atram
ATR	outer
ATRTN	atherton
ATRY	atri
ATRYSPS	atriceps
ATRZ	etters
ATTLY	attlee
ATV	athow
ATVATR	atwater
ATVD	atwood
ATV	etue
ATVL	attewell
ATVL	atul
ATV	oto
ATV	otto
ATVSAN	otoosan
ATVS	athos
ATVSY	atusi
ATVVD	atwood
ATVVL	attewell
ATVYL	attewell
ATYA	atiya
ATY	athey
ATYG	attig
ATYLRD	ethilrede
ATYLRDH	ethilrede
ATYLYV	attilio
ATYNGR	ettinger
ATYNY	etienne
ATYNZVN	etinzon
ATYS	atish
ATYVL	attewell
ATYYA	atiya
AVACA	ewacha
AVAD	oued
AVADYA	awadia
AVALD	ewald
AVAN	awan
AVANZ	evans
AVASTY	awasthi
AVBAJA	obadja
AVBRAYAN	obrien
AVBRDVRFR	oberdorfer
AVBRHVLZ	oberholz
AVBRHYM	oberheim
AVBR	ober
AVBRTAS	obertas
AVBRY	aubrey
AVBRY	aubrie
AVBYD	ubaid
AVBYNGM	obbingem
AVCARD	orchard
AVCAR	owchar
AVCLND	auckland
AVCZ	ochs
AVDDY	oddy
AVDKRYK	oudekirk
AVDKYRK	oudekirk
AVDL	odell
AVDLY	audley
AVDRA	audra
AVDRGV	ouedraogo
AVDVAK	odwak
AVDVN	audun
AVDV	udo
AVDYVM	odum
AVFNR	uffner
AVFYNGTVN	uffington
AVGAR	ugur
AVGBVRN	ogborn
AVGLT	aoglat
AVGNH	eugene
AVGNYV	eugenio
AVGVR	augor
AVGVRY	aogori
AVGVST	august
AVGVSTV	augusto
AVGVSTYN	augustyn
AVGYNH	eugene
AVHALVRAN	ohalloran
AVHRMN	ohrman
AVJN	augen
AVKLND	auckland
AVKLY	oakley
AVKR	auker
AVKRAYN	ukraine
AVKR	ocker
AVKSLY	oxley
AVKSTVN	oxton
AVKSVL	oxwell
AVKT	awketts
AVKTS	awketts
AVKTZ	awketts
AVKYNZ	oakins
AVKYTS	awketts
AVLAFSVN	olafson
AVLA	olah
AVL	awel
AVLAYVVLA	olivola
AVLD	auld
AVLDKVRN	oldcorn
AVLDRAYT	auldridge
AVLDRYJ	auldridge
AVLDZ	olds
AVLMN	ullman
AVL	owl
AVLSN	olsen
AVLSN	olson
AVLSVN	olson
AVLSVN	olsson
AVLVSTAD	ulvestad
AVLYMA	ulima
AVLYNG	aveling
AVLY	ole
AVLY	olli
AVLYVYH	olivie
AVLYVYR	olivier
AVMAKY	ohmaki
AVMBRGR	umberger
AVMGA	omega
AVMLAS	umlas
AVMR	ommer
AVNAT	onat
AVN	aun
AVNAYZA	unaiza
AVNAYZ	unaiza
AVNGLYSTA	evangelista
AVNG	ong
AVNSTY	onesty
AVNSVN	evenson
AVNVSKV	onosko
AVNYL	avniel
AVNYL	oneill
AVNZ	owens
AVQVAQ	ougouag
AVRAHAM	avraham
AVRAM	avram
AVRAYL	averill
AVRAYS	averice
AVRAYZ	averies
AVRAYZ	averis
AVRBN	orban
AVRCARD	orchard
AVRDALN	aurdalen
AVRFYVS	orpheus
AVRGAN	organ
AVRHAN	orhan
AVRHAN	orhun
AVRHART	everhart
AVRHRT	everhart
AVRHV	aurho
AVRKLYVN	aurkleven
AVRKNY	orkney
AVRLANDV	orlando
AVRL	averell
AVRLYNZ	orleans
AVRMA	urma
AVRM	orem
AVRMSPVRDN	ormesporden
AVRN	orne
AVRNVPN	aurnupen
AVR	ore
AVRSBRG	eversberg
AVRSLR	oursler
AVRTS	everts
AVRTYZ	ortiz
AVRVM	avrum
AVRV	orue
AVRVYL	orville
AVRY	every
AVRYGA	auriga
AVRYK	averice
AVRYL	averell
AVRYL	averill
AVRYNTS	variants
AVRYS	averice
AVRYS	averies
AVRYS	averis
AVRY	uri
AVRYVLY	aureole
AVRYVN	orion
AVRYVRDAN	oriordan
AVRYZ	averies
AVSAL	oshall
AVSBVRN	osborne
AVSBVRN	osburn
AVSLANDR	auslander
AVSLYNA	aucellina
AVSN	olsen
AVSN	osen
AVSNZ	owens
AVSTBANN	austbanen
AVSTHAMARN	austhamaren
AVSTLYC	ostliche
AVSTNDVRP	oostendorp
AVSTRANDR	ostrander
AVSTRNDR	ostrander
AVSTVLYN	austvollen
AVSTVRYN	austvorren
AVSTYN	austin
AVSYVN	oseven
AVSYZ	oseas
AVTAGVRV	otaguro
AVTA	otha
AVTH	oetje
AVTJH	oetje
AVTJ	oetje
AVTLV	otello
AVTLV	ottello
AVT	oetje
AVT	ott
AVTRY	awtrey
AVTVLYNY	ottolini
AVTV	otto
AVTYS	otis
AVVLYV	avolio
AVVRDAL	overdal
AVVRPK	overpeck
AVYAN	avian
AVYARS	oyarce
AVYCAY	avichay
AVYK	aveek
AVYNAS	avinash
AVYNG	ewing
AVYNZ	ewins
AVYRSA	aversa
AVYS	avis
AVYSNA	avicenna
AVYVA	aviva
AVYVN	aoyoun
AVZBRN	osburn
AVZGVR	ozgur
AVZMN	ozmen
AVZVNYS	ouzounis
AYALA	ayala
AYBAC	ebach
AYBAR	ibar
AYBL	aibel
AYBYRVNK	ibironke
AYCAS	eachus
AYCBVRN	ayckbourn
AYCYRV	ichiro
AYDA	aida
AYDA	ida
AYDAN	idun
AYDMN	eidam
AYDNBVRG	edenborough
AYD	oude
AYDS	eads
AYDVAYSVZ	ludovicus
AYDVRY	idury
AYDYD	aidid
AYDY	eady
AY	eye
AYF	ifje
AYFJH	ifje
AYFJ	ifje
AYFVFL	stoffel
AYFV	ifo
AYGAN	egan
AYGLASTVN	eaglestone
AYGLSTVN	eaglestone
AYGLV	igloo
AYGLY	egli
AYGRT	eggert
AYGRTVN	egerton
AYGV	igoe
AYGVR	igor
AYJH	aetje
AYJLSTVN	eaglestone
AYJVYN	ijuin
AYK	aik
AYKAM	eckam
AYKARVS	icarus
AYKBRN	ayckbourn
AYKBVRN	ayckbourn
AYKH	ike
AYKLVZAN	iclozan
AYKN	aiken
AYKVK	aycock
AYLANA	ilana
AYLAN	ilan
AYLKA	ilkka
AYLMYN	ilmin
AYLPV	ilpo
AYLR	iler
AYLSA	ailsa
AYLTH	aeltje
AYLVARD	aylward
AYLVR	aylor
AYLVT	aylott
AYLVT	eliot
AYLVYZA	eloisa
AYLYA	ilia
AYLYDYV	ilidio
AYLYN	aileen
AYLYN	ayling
AYLYN	eileen
AYLYNG	ayling
AYLYN	ileen
AYLYS	eyles
AYLYS	ilyess
AYLZ	eales
AYM	aim
AYMAN	aiman
AYMAN	ayman
AYMANTZ	imants
AYMAR	imar
'AYMN	ayman
AYMN	ayman
AYMN	eyman
AYMRY	emery
AYMVN	eamon
AYMY	aimee
AYNAC	ienatch
AYN	ain
AYNA	inna
AYNANA	inanna
AYNAN	inan
AYNARYNV	eannarino
AYNAT	aernoudt
AYN	ayn
AYNAYN	inauen
AYNC	inch
AYNDALYS	indulis
AYNDAYRSN	indiresan
AYNDRA	indra
AYNDRAJYT	indrajit
AYNDRANYL	indranil
AYNDRLY	indrelee
AYNDSVRS	endesworth
AYNDVY	indewey
AYNGALZ	ingalls
AYNG	auyeung
AYNG	ing
AYNG	inge
AYNGLD	ingold
AYNGLF	ingolf
AYNGL	ingle
AYNGLS	ingles
AYNGLYS	english
AYNGLYS	inglis
AYNGMAR	ingemar
AYNGMAR	ingmar
AYNGRAHAM	ingraham
AYNGRAM	ingram
AYNGRM	ingram
AYNGRSVL	ingresole
AYNGRYA	ingria
AYNGRYD	ingrid
AYNGRYSL	ingresole
AYNGRYSVL	ingresole
AYNGVAR	ingvar
AYNGYJD	engaged
AYNHV	inho
AYNJH	eyntje
AYNJJNRY	ingegneri
AYNKH	einke
AYNKVGNYTA	incognita
AYNLY	ainley
AYNMN	inman
AYNR	inner
AYNS	ines
AYNS	innes
AYNSR	ainsaar
AYNT	aint
AYNTAYR	intyre
AYNT	eyntje
AYNTH	eyntje
AYNTJ	eyntje
AYNTJH	eyntje
AYNTLSAT	intelsat
AYNTRNT	internet
AYNTRNT	interrante
AYNVKSN	enoksson
AYNVN	eynon
AYNVSNT	innocent
AYNYSA	ainissa
AYNZ	eyntje
AYNZHNRY	inzhenery
AYNZ	inez
AYNZ	innes
AYPRSVN	epperson
AYPRT	eppert
AYR	air
AYRARDY	ierardi
AYRAY	airay
AYRBYD	irbid
AYRD	aird
AYRDV	airdo
AYR	eyre
AYR	iyer
AYRLAYNZ	airlines
AYRL	earl
AYRLND	ireland
AYRNST	earnest
AYRNVT	aernoudt
AYRP	earp
AYRS	ayers
AYRVN	aaron
AYRVN	airoun
AYRVNSVN	aronson
AYRVVD	yearwood
AYRVYNG	irving
AYRVYN	irvin
AYRVYN	irwin
AYRVYYN	irwin
AYRY	airay
AYRYK	eirik
AYRYS	ariss
AYRYZARY	irizarry
AYRZ	ayers
'AYSA	aiesha
AYSA	aiesha
'AYSA	ayesha
AYSA	ayesha
AYS	ace
AYSA	eassa
AYSAK	isaac
AYSAK	isacq
AYSAKS	isaacs
AYSAMA	aissama
AYSAN	eason
AYSASK	isacq
AYSBL	isbell
AYSFALZ	icefalls
'AYSH	aiesha
AYSH	aiesha
'AYSH	ayesha
AYSH	ayesha
AYS	ice
AYSKANDR	iskander
AYSK	isecke
AYSLT	iselt
AYSLYK	icelic
AYSMAN	isman
AYSMN	isman
AYSNSTAT	aisenstat
AYSPVRT	iceport
AYSRAT	israt
AYSRT	eisert
AYSRT	israt
AYSTBRN	eastburn
AYSTLND	eastland
AYSTMAS	isthmus
AYSTMN	eastman
AYSTMVS	isthmus
AYSTRAGV	estrugo
AYSTRBRVK	easterbrook
AYSTR	easter
AYSTR	eyster
AYSTVVD	eastwood
AYSTVY	eastway
AYSTYK	eastick
AYSTYN	istian
AYSVN	asson
AYSVN	ayson
AYSY	ayse
AYSYZAKY	ishizaki
AYT	aetje
AYT	ait
AYTAMAR	itamar
AYTCV	aitcho
AYTCVN	itchon
AYTH	aetje
AYTH	oetje
AYTJ	aetje
AYTJ	oetje
AYTJY	oetje
AYTKN	aitken
AYTR	eater
AYTSN	aitsen
AYVA	iowa
AYVALD	ewald
AYVANZ	evans
AYVAR	ivar
AYVAYNG	ewing
AYVGNH	eugene
AYV	ilieve
AYVJNH	eugene
AYVLYN	evelyn
AYVND	eivind
AYVNS	evens
AYVRS	evers
AYVRSVN	iverson
AYVRY	ivery
AYVS	ayush
AYVS	eos
AYVSTYS	eustis
AYVSV	ayuso
AYVSYN	eosin
AYVTYK	ivetic
AYVYN	eoin
AYZAK	isacq
AYZAKSVN	isakson
AYZCYL	ezechiel
AYZDY	izadi
AYZ	eyes
AYZL	eisele
AYZMN	isman
AYZRVDA	izroda
AYZV	izzo
AZAD	azad
AZALYA	azalea
AZALY	azalea
AZANA	ozuna
AZAR	azhar
AZBVRN	osborne
AZCYL	ezechiel
AZHR	azhar
AZLA	azalea
AZLN	azlan
AZR	ezor
AZVR	azure
AZYCL	ezechiel
BAABAR	baabar
BAAFJ	baefje
BABA	baba
BABA	babah
BABAH	babah
BABAR	baabar
BABAR	babar
BAB	bob
BAB	bobe
BAB	bubb
BABK	baback
BABK	babak
BABL	bubble
BABR	baabar
BABT	babette
BABV	babu
BABVRAV	baburao
BABVSKYN	babushkin
BABY	bobbi
BABY	bobbie
BABY	bobby
BABYKV	babikow
BABYRL	buberel
BABYTZ	babitz
BACALTR	buchalter
BACARAC	bacharach
BACAS	bachus
BAC	butch
BACLDR	batchelder
BAD	bud
BAD	budd
BADKK	badcock
BADKVK	badcock
BADLVC	badeloch
BADMN	bodman
BADNYK	budnick
BADR	budur
BADRMN	baderman
BADRYK	badrick
BADVYN	bauduyn
BADVYYN	bauduyn
BADY	buddy
BADYG	budig
BADYN	baden
BADYN	bauduyn
BADYNGTN	baldington
BADYNGTVN	baldington
BADYVN	bauduyn
BADZ	budds
BADZYAK	budziak
BAFL	baffle
BAFY	baefje
BAFY	buffy
BAGA	bagga
BAGAM	baugham
BAGARLY	baggarly
BAGAY	bugay
BAGDAN	bogdon
BAGHAM	baugham
BAGLY	bagley
BAGLY	buggelli
BAGM	baugham
BAGSAV	bagshawe
BAGVLY	baguley
BAGYD	bagade
BAGZ	boggs
BAGZ	bugs
BAHYH	bahija
BAJVA	bajwa
BAJYK	bajic
BAKAR	bacar
BAKAS	backas
BAKAYA	bakaya
BAKLY	buckley
BAKNR	buckner
BAKR	bacar
BAKR	baker
BAKSKA	bocska
BAKSR	buckser
BAKSY	bakshee
BAKVM	baucom
BAKVS	bakos
BAKY	bucky
BAKYR	baqir
BALAK	bullock
BALANDR	bolinder
BALANS	ballance
BALARD	ballard
BALARY	balarie
BALAS	balash
BALAST	ballast
BAL	bale
BAL	ball
BALBYR	balbir
BALCVNAS	balchunas
BALD	bald
BALDRD	baldred
BALDVR	baldur
BALDYNGTN	baldington
BALDYNGTVN	baldington
BALFNZ	balfanz
BALGA	balqa
BALHAM	balham
BALKA	balqa
BALKVSKY	bulkowski
BALMA	balma
BALMASDA	balmaseda
BALMR	balmer
BALNDRA	balendra
BALNY	balleny
BALSAM	balsam
BALSARA	bulsara
BALSK	bolecek
BALSLY	balsley
BALSVN	balson
BALTAKS	baltaxe
BALTAYS	baltais
BALTAZAR	balthazar
BALTZL	baltzell
BALV	balu
BALY	bally
BALYGA	baliga
BALYK	balike
BALYN	baleine
BALYN	balin
BALYSTYK	ballistic
BALYT	balit
BAMBRGR	baumberger
BAMN	bommen
BAMSV	bumsoo
BANA	banna
BANABYV	bonnabeau
BAN	bon
BAN	bunn
BAND	bond
BANDD	banded
BANDYRDY	bandireddi
BANDZ	bonds
BANGARTZ	bongarts
BANG	bunge
BANGRZ	bungers
BANKLR	bankler
BANKRAFT	bancroft
BANKRVFT	bancroft
BANKS	banks
BANKVALA	bankwalla
BANL	bonnell
BANR	bonner
BANTVN	banton
BANTY	bounty
BANTYNG	bunting
BANY	bonney
BANY	bonni
BANY	bunny
BANYTA	bonita
BANYTV	bonito
BANYVRA	bonura
BAP	bop
BAPTYSTA	baptista
BAPTYST	baptist
BARAKVTA	barracouta
BARAS	barath
BARASV	barroso
BARAT	barratt
BARBAGALV	barbagallo
BAR	bar
BARBAS	barbas
BARBR	barber
BARBVRAK	barborak
BARBVR	barbour
BARBY	barbee
BARD	bard
BARDVLVMZ	bartholomeus
BARDYK	burdick
BARF	barff
BARFRD	barford
BARFVRD	barford
BARFYT	burfitt
BARG	burg
BARGS	bargus
BARGVS	bargus
BARH	barre
BARJYL	bargiel
BARKALV	barculo
BARKASFYLD	barksfield
BARKAY	barkai
BARK	bark
BARKLY	barkley
BARKRAFT	barcroft
BARKR	barker
BARKSDYLY	barksdale
BARKSFYLD	barksfield
BARKVLV	barculo
BARKVS	barcus
BARLAS	barlas
BARL	barrel
BARL	burrell
BARLV	barlow
BARNABY	barnaby
BARNAM	barnum
BARNARD	barnard
BARNAS	barnas
BARN	baron
BARND	barend
BARNSA	barnshaw
BARNSAV	barnshaw
BARNSV	barnshaw
BARNT	barnett
BARNY	barney
BARNYK	baronick
BARQARD	burghard
BARS	barth
BARSY	barsai
BARTA	barta
BART	barrett
BART	barth
BARTHVLVMYVS	bartholomeus
BARTK	bartok
BARTKVR	barthakur
BARTL	bartelle
BARTL	bartle
BARTLMAS	bartelmus
BARTLMVS	bartelmus
BARTLT	bartelt
BARTLT	bartlett
BARTLY	bartley
BARTMVS	bartelmus
BARTN	barton
BARTN	burton
BARTVK	bartok
BARTVLVMVS	bartholomeus
BARTVLVMYVS	bartholomeus
BARTVLYNY	bartolini
BARTVN	barton
BARTVNYKV	bartonico
BARTY	baertie
BARTY	beartie
BARTYH	beartie
BARTYS	beatrice
BARTZ	bartz
BARVA	barua
BARVC	baruch
BARVN	baron
BARVN	barone
BARVNS	baroness
BARVNYA	baronia
BARVZ	burrows
BARYAKS	bariaux
BARY	bari
BARY	barrey
BARY	barrie
BARY	barry
BARYNGR	barringer
BARYNGTN	barrington
BARYNGTVN	barrington
BARYS	burris
BASA	basha
BAS	bas
BAS	boss
BASKAR	baskar
BASKRVYL	baskerville
BASKY	bosky
BASL	bassle
BASMA	basma
BASN	basson
BASR	basher
BASSA	bosscha
BASSN	bastion
BASTARD	bastard
BAST	bassett
BASTYK	bostic
BASTYLVS	bustillos
BASTYN	bastiaan
BASTYN	bastien
BASTYN	bastion
BASTYVN	bastion
BASVAL	boswall
BASV	basso
BASV	basu
BASVM	bossom
BASYL	basil
BASYLYKA	basilica
BASYLYSK	basilisk
BASYLYVS	basilius
BASYN	basin
BATALS	buttuls
BATAN	battan
BAT	bat
BATL	battle
BATLR	butler
BATNAT	buttnut
BATN	button
BATRA	batra
BATRBY	batterbee
BATRS	buttress
BATRSS	buttresses
BATRST	bathurst
BATRVRS	butterworth
BATRYS	beatrice
BATRZ	buttress
BATY	battey
BATYL	bataille
BATYNG	botting
BAVA	bawa
BAV	bao
BAVCMP	beauchamp
BAVDN	bawden
BAVDN	bowden
BAVDVYYN	baudouin
BAVDYN	baudin
BAVDYN	bauduyn
BAVDYSYN	baudissin
BAVGMN	baughman
BAVKAM	bawcom
BAVKVS	baukus
BAVM	baum
BAVMGARTNR	baumgartner
BAVPRS	baupres
BAVRY	bowery
BAVS	bauhs
BAVYZ	beavis
BAXVM	bakhoum
BAYARD	bayard
BAY	bai
BAYDA	bayda
BAYDN	bygden
BAYFYLD	byfield
BAYKRASTAF	bickerstaffe
BAYKRZTAF	bickerstaffe
BAYLA	bayla
BAYLS	byles
BAYLY	baillie
BAYLYNGSLY	billingsley
BAYLYNGTVN	billington
BAYLYV	baillieu
BAYLZ	byles
BAYNVN	bynon
BAYPRT	bippert
BAYR	boyer
BAYRD	byrd
BAYRN	bayern
BAYRN	byrne
BAYRTAY	baertie
BAYRTYH	baertie
BAYRVN	byron
BAYSVT	bysouth
BAYZ	byles
BAZBY	buzbee
BAZBY	buzby
BAZT	bazett
BBKAK	babcock
BBYT	bobbitt
BCLDR	batchelder
BCLR	batchelder
BDAL	bdale
'BDALH	abdullah
'BDALLH	abdullah
'BDALRHMAN	abdalrahman
'BDALRHMAN	abdulrahman
'BDALRHMN	abdalrahman
'BDALRHMN	abdulrahman
'BDAL'ZYR	abdulaziz
'BDAL'ZYZ	abdulaziz
'BDHBY	abudhabi
BDKK	badcock
BDKVK	badcock
'BDL	abdul
BDLAK	badeloch
BDL	bedell
BDLVC	badeloch
'BDL'ZYZ	abdulaziz
BDMY	badami
BDNAR	bednar
BDRK	badrak
BDRYK	badrick
'BDVAL'ZYZ	abdulaziz
'BDVL	abdul
'BDVLRHMN	abdulrahman
BDYN	badian
BDYRA	bdira
BDYR	badir
BFJ	baefje
BGDAD	baghdad
BGLY	bagley
BGNVLD	bagnold
BGVYL	bagwill
BGYR	baqir
BHAMND	bahamonde
BHARA	behara
BHNAM	behnam
BHRV	bahro
BHST	behcet
BHYJA	bahija
BJLY	bagley
BKA	beqaa
BKAR	bacar
BK	back
BK	bak
BK	beck
BKDVR	backdoor
BKHVRST	backhurst
BKMN	backman
BKMN	beckman
BKMYR	beckmeyer
BKR	bacar
BKR	backer
BKR	baker
BKR	becker
BKS	bex
BKT	beckett
BKVA	beqaa
BKVF	backof
BKVK	bocock
BKVY	backway
BKVYT	beckwith
BKVYYR	baqir
BKY	becky
BKY	bekki
BKYNGSAL	beckingsale
BKYNGSL	beckingsale
BKYNGSYL	beckingsale
BKYR	baqir
BKYS	bekis
BLA	bela
BLAC	bloch
BLAF	bluff
BLAFS	bluffs
BLAHA	blaha
BLAK	block
BLAKSVM	bloxom
BLALAK	blalock
BLAL	bilal
BLAL	blal
BLAM	blum
BLAMKH	blumcke
BLAMY	bellomy
BLANCARD	blanchard
BLANCH	blanche
BLANSDAN	blunsdon
BLANSDN	blunsdon
BLANSTAN	blanstan
BLANZDVN	blunsdon
BLAS	bulus
BLASDN	blunsdon
BLASK	blask
BLASR	blosser
BLASY	blasi
BLASYVS	blasius
BLAVADNYK	blavatnik
BLAVYZ	blyweiss
BLAYT	blight
BLAZ	blaz
BLAZK	blazek
BLAZKYYVZ	blazquez
BL	bell
BLDN	bolden
BLDRD	ballard
BLDVYJN	boldwijn
BLDVYN	boldwijn
BLDVYYN	boldwijn
BLDYNG	belding
BLDYNGTVN	baldington
BLGA	balqa
BLKA	balqa
BLK	black
BLKLND	blokland
BLKLY	blackley
BLKMN	blackman
BLKMN	blakeman
BLKSVM	bloxom
BLKSYR	blacksher
BLKVL	blackwell
BLNK	blank
BLNKHVRN	blenkhorn
BLNKV	blencowe
BLNKY	belenky
BLS	blas
BLTBRG	blattberg
BLTRAV	beltrao
BLV	bello
BLVC	bloch
BLVHM	blohm
BLVKSVM	bloxom
BLVM	blum
BLVMBRG	bloomberg
BLVMN	blumen
BLVMNFLD	blumenfeld
BLVNSDVM	blunsdon
BLVNSDVN	blunsdon
BLVNZDM	blunsdon
BLVRNJ	blorenge
BLVSKVM	bloxom
BLVYN	belvin
BLVZ	bulus
BLVZVM	bloxom
BLYK	blaik
BLYK	blake
BLYN	blain
BLYN	blane
BLYNDA	belinda
BLYNGASLY	billingsley
BLYNGTN	billington
BLYNKV	blencowe
BLYNKV	blinco
BLYNKVV	blencowe
BLYR	bleier
BLYSTVN	blystone
BLYTA	blatta
BLYVYS	blyweiss
BLYZ	blaze
BNAKSY	bonacci
BNAMAR	benamar
BNAN	banan
BNARY	benari
BN	ben
BNDANG	bandung
BNDASTVN	bandstone
BNDK	bendek
BNDLY	bandali
BNDR	bender
BNDRVB	banderob
BNDY	bandy
BNG	bang
BNG	beng
BNG	benge
BNGT	bengt
BNH	bene
BNJYMAN	benjiman
BNKR	banker
BNKR	benker
BNKS	banks
BNR	benner
BNS	bense
BNSN	bensen
BNSN	benson
BNSVN	benson
BNT	benet
BNT	bengt
BNT	bennet
BNTLY	bentley
BNTN	benten
BNTN	benton
BNTV	bentow
BNTVN	benton
BNTZ	bennetts
BNTZ	bentz
BNYA	baniya
BNYAMYN	beniamin
BNYFASYVS	bonifacius
BNYN	bonin
BNZ	benz
BNZN	benzene
BQYR	baqir
BRABANT	brabant
BRABY	barraby
BRACMN	brachman
BRAD	brode
BRAD	broude
BRADLY	bradley
BRADR	brother
BRADRTN	brotherton
BRADRTVN	brotherton
BRADSAV	bradshaw
BRADY	brady
BRADYS	bradish
BRAFVRD	brafford
BRAGHAM	brougham
BRAHAM	braham
BRAHYM	brahim
BRAK	brock
BRAKLY	brockley
BRAKNY	brackney
BRAMBAV	brumbaugh
BRAM	bram
BRAMR	brummer
BRAN	bran
BRAN	bron
BRAN	broun
BRANDL	braendle
BRANDY	brandi
BRANN	brannen
BRANSAV	branshaw
BRANSDVN	brunsdon
BRANSKVMB	branscombe
BRANSVYK	brunswick
BRANT	brandt
BRANT	brunt
BRARDY	berardi
BRASARD	brassard
BRASAYR	brashier
BRASRZ	brashers
BRASYRZ	brashears
BRAT	barratt
BRATLT	bartlett
BRATR	brater
BRATYNA	bratina
BRAVN	brawn
BRAVN	brown
BRAVNFYLD	brownfield
BRAVNR	browner
BRAVNYNG	browning
BRAVTVN	braughton
BRAVV	bravo
BRAVYC	bromwich
BRAYAN	bryan
BRAY	brie
BRAYD	bryde
BRAYN	brien
BRAYNKLR	brinkler
BRAYR	brier
BRAYS	brice
BRAYS	bryce
BRAYSLAV	berislav
BRAYSVN	bryson
BRAYT	bright
BRAYTN	britten
BRAYTVN	brighton
BRAYTVYT	braithwaite
BRAZVN	bruzzone
BR	burr
BRBVR	barbour
BRCA	brejcha
BRCR	brecher
BRD	beard
BRD	brod
BRDLY	bradely
BRDLY	bradley
BRDLY	bradly
BRDN	borden
BRDN	braden
BRDN	burden
BRDSANG	birdsong
BRDSAV	bradshaw
BRDY	brady
BRDYK	burdick
BRDYT	burditt
BRFVRD	barford
BRGANTY	briganti
BRGARD	burgaard
BRGAYLV	borgailo
BRG	berg
BRG	borg
BRGDAN	bragdon
BRGLAND	berglund
BRGL	bergel
BRGMN	bergman
BRGR	berger
BRGS	bargus
BRGS	burgess
BRGSVN	borgeson
BRGYVT	bergeot
BRHAN	burhan
BRJ	burj
BRKAH	barkah
BRKASPYR	breakespear
BRKAT	barakat
BRKAT	bearcat
BRK	berk
BRK	brake
BRK	breck
BRKLY	berkley
BRKSFYLD	barksfield
BRKT	barakat
BRKVL	boerkoel
BRKVVYC	bercovich
BRKY	berkey
BRLACR	berlocher
BRL	burl
BRLND	borland
BRLSVN	burleson
BRLV	barlow
BRLYN	berlin
BRLYNG	bierling
BRLYNG	burling
BRML	bermel
BRMN	berman
BRMN	bormann
BRNADVS	bernadus
BRNAL	bernal
BRNAN	brennan
BRNARD	barnard
BRNARD	bernard
BRNARDV	bernardo
BRNARDY	bernardi
BRNARDYN	bernardin
BRNARDZ	bernards
BRNCAVD	branchaud
BRNC	branch
BRNCLY	brenchley
BRNDAN	brendan
BRND	berend
BRND	bernd
BRND	brand
BRNDL	brandel
BRNDL	brandelle
BRNDS	berends
BRNDVN	brendon
BRNDY	brandi
BRNDY	brandy
BRNDYS	brandeis
BRNHARD	bernhard
BRNHART	bernhardt
BRNHR	bernher
BRNR	brenner
BRNSAV	barnshaw
BRNSV	barnshaw
BRNT	bernt
BRNT	brent
BRNT	burnette
BRNV	berno
BRNVL	barnwell
BRNY	bernie
BRNY	burney
BRNYR	bernier
BRNZ	burns
BRQ	bargh
BRSAV	barnshaw
BRS	beresh
BRSFVRD	beresford
BRSLAV	breslau
BRSLR	bresler
BRSMN	bressman
BRSVN	burson
BRSY	bresee
BRT	burt
BRTLSVN	bertelson
BRTN	burton
BRTRAND	bertrand
BRTR	brater
BRTS	burts
BRTVN	berton
BRTVN	breton
BRTVN	burton
BRTY	baertie
BRTY	beartie
BRTYH	baertie
BRVANHAT	braunhut
BRVARK	browarek
BRVDA	broda
BRVD	breaud
BRVDFYLD	broadfield
BRVDHAST	broadhurst
BRVDLY	broadley
BRVDR	broder
BRVDRTVN	brotherton
BRVHL	brohl
BRVKAV	brokaw
BRVK	brock
BRVK	brook
BRVK	brooke
BRVK	bruck
BRVKN	broken
BRVKNR	brueckner
BRVKR	brooker
BRVKS	brooks
BRVKSL	brooks
BRVKVL	brookwell
BRVKZ	brooks
BRVMBRG	bromberg
BRVMBRGR	bromberger
BRVMFYLD	brumfield
BRVMLY	bromley
BRVMYJ	bromage
BRVNL	brunelle
BRVNR	bruner
BRVNVYYN	brunwin
BRVNYYV	bruneau
BRVR	brewer
BRVSRD	brossard
BRVSTR	brewster
BRVSYAV	brousseau
BRVTY	bruty
BRVTZMN	brutzman
BRVVR	brewer
BRVYK	brevik
BRVYLV	broilo
BRVYN	bruyn
BRVYNS	bruines
BRVYNYNG	bruening
BRVYR	breuer
BRVYR	brewer
BRVZ	broz
BRXARD	burkhard
BRYAN	briand
BRYAN	bryan
BRYANT	bryant
BRY	barrie
BRY	barry
BRY	berry
BRY	bray
BRYBR	briber
BRY	bree
BRY	bri
BRYDLAV	breedlove
BRYDVL	bridwell
BRYDY	brady
BRYDYNG	breeding
BRYGVY	bryguy
BRYJ	bridge
BRYJ	brij
BRYJMN	bridgman
BRYKASPYR	breakespear
BRYKSPYR	breakespear
BRYL	beryl
BRYM	bream
BRYMR	brimmer
BRYMSTVN	brimstone
BRYN	berin
BRYN	bryn
BRYNDAN	breanndan
BRYND	brind
BRYNDL	brindle
BRYNGARDNR	bringardner
BRYNGTN	barrington
BRYNGTVN	barrington
BRYNK	brink
BRYNKMN	brinkman
BRYNR	bryner
BRYNSN	brinson
BRYR	barrier
BRYR	breyer
BRYS	beris
BRYS	bryce
BRYSBYN	brisbane
BRYSBYN	brisbin
BRYSNV	briceno
BRYSTVL	bristol
BRYSYNDA	brisinda
BRYTA	brita
BRYT	britt
BRYTLYNG	breitling
BRYTV	brito
BRYTVN	breton
BRYTYS	british
BRYVN	bryon
BRYVNY	bryony
BRYVR	brewer
BRYVRY	brewery
BRYYKPR	breakespear
BRYYTVN	britton
BRYZA	bereza
BRZA	bereza
BSAK	bosak
BSAM	besam
BS	bess
BSBRYS	besbris
BSKT	baskett
BSKV	besko
BSL	basle
BSMA	basma
BSMY	basma
BST	bassett
BSVAL	boswall
BSVL	boswell
BSVN	bossom
BSYL	basil
BSYM	basim
BSYRA	basira
BSYT	basit
BTAN	bethan
BTCLDR	batchelder
BTHVN	beethoven
BTL	bethel
BTMN	bateman
BTRYS	beatrice
BTSY	betsy
BTVL	batul
BTY	beti
BTY	betty
BTYG	bettig
BTYYV	bettio
BTZA	betza
BVALY	bouali
BVAS	bouas
BVAY	booey
BVAY	buay
BVAYVYN	boivin
BV	bev
BVBY	booby
BVBYS	bobbish
BVCA	boschga
BVCA	bosscha
BVC	butch
BVCGA	boschga
BVDA	bozuwa
BVDA	buda
BVDAPATY	bodapati
BVDAR	budur
BVD	bode
BVD	bud
BVD	budd
'BVDHABY	abudhabi
BVDLA	bodla
BVDN	boden
BVDN	bowden
BVDNMYLR	bodenmiller
BVDRA	budur
BVDRV	boudreau
BVDV	bodo
BVDVR	budur
BVDVYN	boudeweyn
BVDY	budi
BVDYVN	boudeweyn
BVDYVYN	boudeweyn
BVFALV	buffalo
BVGARD	bogaard
BVGHAM	baugham
BVGS	bugos
BVHL	buhl
BVHR	booher
BVJY	boije
BVKL	bokel
BVKL	buckle
BVKLY	buckley
BVKR	boker
BVKSY	buxey
BVKVN	bockoven
BVLA	bulla
BVLARD	bullard
BVL	bool
BVLDN	bolden
BVLDT	boldt
BVLDVYJN	boldwijn
BVLDZR	bulldozer
BVLF	bolef
BVLN	bolen
BVLR	boller
BVLR	buller
BVLTAN	bolton
BVLTN	boulton
BVLTVN	boulton
BVLV	bulow
BVLVC	bulloch
BVLVS	bulus
BVLVYJN	boldwijn
BVLYNG	bowling
BVMBR	bomber
BVMBRGR	bomberger
BVM	bum
BVMGARDNR	bumgardner
BVMHARD	bomhard
BVMN	bowman
BVNANDR	bonander
BVNAR	bonar
BVNAVGLYA	bonavoglia
BVN	boon
BVN	bowen
BVNGARD	bongard
BVNSTRA	boonstra
BVNTN	bunten
BVNVMV	bonomo
BVNVNV	bononno
BVNY	bonnie
BVNYFASS	bonifacius
BVNYFASYVS	bonifacius
BVNYFKYVS	bonifacius
BVNYFYSS	bonifacius
BVNYN	bonin
BVNYTZ	bonitz
BVQAM	baugham
BVRA	boora
BVRAD	borud
BVRAP	burrup
BVRASCY	buraschi
BVR	bouwer
BVRCRT	borchert
BVRDR	border
BVRDYK	burdick
BVRGA	borge
BVRG	borg
BVRGV	bourque
BVRGYVYS	bourgeois
BVRJYA	bourgea
BVRKVAL	boerkoel
BVRKVL	boerkoel
BVRKVYL	boerkoel
BVRKY	borecki
BVRL	borel
BVRL	borrell
BVRLN	bourlon
BVRM	borm
BVRML	bormel
BVRMN	bormann
BVRSL	bursell
BVRST	borst
BVRSYR	bourcier
BVRVS	burrows
BVRYJ	beveridge
BVRYL	burrill
BVRYLLV	borriello
BVRYS	borris
BVRYVN	borione
BVRYZ	borries
BVRZ	bouwers
BVSA	busa
BVSAL	boswall
BVSART	bossart
BVSARV	busarow
BVSAYSN	boshuysen
BVS	boose
BVS	bos
BVS	bose
BVS	boss
BVS	busch
BVS	bush
BVSCA	bosscha
BVSCGA	boschga
BVSGA	boschga
BVSKA	bosscha
BVSK	buceck
BVSLY	bosley
BVSNL	bushnell
BVSNY	bosnia
BVSTAK	bostak
BVSTAMNT	bustamante
BVST	bost
BVSTRAM	bostrom
BVSTRVM	bostrom
BVSTVN	boston
BVSTYK	bostwick
BVSVAL	boswall
BVSVL	boswell
BVSVM	bossom
BVSVN	bosson
BVSVR	bushore
BVSVYSN	boshuysen
BVSY	bocci
BVSY	bucci
BVSYK	busick
BVSYSN	boshuysen
BVSYVYSN	boshuysen
BVTARY	botari
BVTAYS	butaysh
BVT	boutte
BVT	butte
BVTCR	butcher
BVTLR	butler
BVTRL	bottrell
BVTRS	buttress
BVTSYH	bootsie
BVTVN	bouton
BVTZ	botez
BVVDVYN	boudeweyn
BVVN	bowen
BVVY	bowie
BVXNY	boukhny
BVY	bowie
BVYKV	boyko
BVYLN	boylan
BVYR	bowyer
BVYRKVYL	boerkoel
BVYS	beavis
BVYS	boyes
BVYSVYKS	boisvieux
BVYSYV	boisseau
BVYVN	boivin
BVYZY	boisy
BVZANCYV	bojanchev
BVZ	boaz
BVZKART	bozkurt
BVZMAN	bozeman
BVZVA	bozuwa
BVZVAL	boswall
BVZVVA	bozuwa
BVZVVYL	beuzeville
BVZYDAR	bozhidar
BVZYD	bouzid
BYAKV	biacco
BYAN	bian
BYANG	byung
BYANGTAY	byungtae
BYATLYNG	beutling
BYAVYS	beavis
BY	bee
BYBL	bible
BYBR	bieber
BYCAM	beacham
BYC	beach
BYCLY	beachley
BYCMP	beauchamp
BYCYNGSYL	beckingsale
BYCZ	beaches
BYDA	bayda
BYDL	beedle
'BYD	ubaid
BYDV	beddow
BYDVL	bidwell
BYDY	bidee
BYF	baefje
BYFJH	baefje
BYFRAST	bifrost
BYG	big
BYGLHL	beaglehole
BYGND	bigend
BYGNVALD	bigenwald
BYGV	bigo
BYGVRDAN	bigourdan
BYGZ	biggs
BYHAN	beyhan
BYHYV	beehive
BYJ	baefje
BYJH	baefje
BYKA	beqaa
BYKARD	bechard
BYK	beck
BYK	beek
BYK	bick
BYK	bik
BYKLY	beakley
BYKN	baken
BYKNST	bakeneset
BYKRASTAF	bickerstaffe
BYKRASTAFY	bickerstaffe
BYKRASTF	bickerstaffe
BYKRASTYF	bickerstaffe
BYKR	baker
BYKRSTF	bickerstaffe
BYKRTN	bickerton
BYKSLR	bixler
BYKVL	bakewell
BYKVN	bacon
BYLAL	bilal
BYLANY	billany
BYL	beale
BYL	beyl
BYL	bill
BYLHAR	bilhar
BYLKY	bielecki
BYLNGTVN	billington
BYLR	beeler
BYLR	bieler
BYLR	byler
BYLS	byles
BYLV	billo
BYLYKVK	billycock
BYLYNGASLAY	billingsley
BYLYNG	billing
BYLYNGSLY	billingsley
BYLYNGTVN	billington
BYLYNGZ	billings
BYLYNSKY	bilinsky
BYLYR	beeler
BYLZ	bills
BYLZYBAB	beelzibub
BYMN	beaman
BYMYNG	beeming
BYN	bain
BYN	bean
BYN	bien
BYN	bin
BYNDMN	bindemann
BYNFNG	bienfang
BYNG	bing
BYNH	beane
BYNJN	bingen
BYNMDART	bainmedart
BYNQAM	bingham
BYNR	binner
BYNS	bines
BYNS	binesh
BYNVD	binod
BYNVY	binoy
BYNY	beanie
BYNY	binay
BYNY	binnie
BYNYYVN	binion
BYNZ	baines
BYNZ	bains
BYNZ	binns
BYPYN	bipin
BYRA	byra
BYR	bare
BYR	bear
BYR	beer
BYR	beyer
BYR	bir
BYRBK	bareback
BYRC	birch
BYRD	beard
BYRD	byrd
BYRDMR	beardmore
BYRDN	bearden
BYRFYS	bareface
BYRG	birge
BYRGL	birgel
BYRK	birk
BYRLA	barela
BYRMN	bearman
BYRNBVYM	birenboim
BYRN	byron
BYRNH	byrne
BYRNS	byrnes
BYRTAY	beartie
BYRT	baertie
BYRTRYK	beatrice
BYRTYH	baertie
BYRTYH	beartie
BYRVT	beirut
BYRYC	barich
BYRYGANTY	briganti
BYRYNG	bearing
BYRZ	bayers
BYSAYV	bissau
BYS	biess
BYSH	basse
BYSKMP	basecamp
BYSL	bassel
BYSLY	beasley
BYSMARK	bismarck
BYSM	basem
BYSR	bacar
BYSTANDR	bystander
BYST	bisset
BYST	bissett
BYSYN	basin
BYTANKRT	bethancourt
BYTARD	bittard
BYT	beate
BYT	beet
BYTMN	bateman
BYTN	beaton
BYTRAYS	beatrice
BYTRYK	beatrice
BYTZ	bitz
BYVAN	bevan
BYV	beau
BYVCAMP	beauchamp
BYVCMP	beauchamp
BYVDVYN	bauduyn
BYVFYZ	beaufays
BYVGAM	baugham
BYVKMP	beauchamp
BYVKRAFT	biocroft
BYVLY	beaulieu
BYVLYV	beaulieu
BYVMNT	beaumont
BYVMVNT	beaumont
BYVNGS	byungse
BYVR	beaver
BYVRLY	beverly
BYVRZ	beavers
BYVSH	beusee
BYVTL	beutel
BYVYS	beavis
BYVZVYL	beuzeville
BYYVCMP	beauchamp
BYYVNYK	bionic
BYZ	bayse
BYZR	bizer
BYZVANAT	biswanath
BYZVAS	biswas
BYZVYL	beuzeville
BYZYR	bussiere
BZVA	bozuwa
CAGN	schagen
CAKV	chacko
CALK	chalk
CAMBRLAYN	chamberlain
CAMPLYN	champlin
CAND	chand
CANDRAN	chandran
CANDR	chander
CANDVNYA	chandonia
CANSY	chauncy
CANY	chaney
CAPLA	chapela
CAPL	chappell
CAPMN	chapman
CAPRA	chopra
CAPYN	chopin
CARD	chard
CARLTN	charlton
CARLTVN	charlton
CARLVT	charlotte
CARLY	charlie
CARLYH	charlie
CARLYN	charlyn
CARLZ	charles
CARNG	charng
CARTVN	charlton
CARYK	charrick
CAS	chas
CASMZ	chasms
CASTYN	chastain
CATANY	chatane
CAV	chao
CAVDA	chavda
CAVHAN	chauhan
CAVN	chaun
CAVVYN	chauvin
CAVVYV	chauveau
CAVZ	chavez
CAY	chai
CAYKN	chaiken
CAYLD	child
CAYLDZ	childs
CAYZ	chayes
CH	che
CKRD	checkered
CLATVN	chellaton
CLYVS	chelius
CLYYAN	chelian
CMALY	chemaly
CMBRLYN	chamberlain
CMBRZ	chambers
CMBZY	chembezi
CNADR	chenader
CN	chen
CND	chande
CNDLR	chandler
CNSLVR	chancellor
CNTH	chenteh
CNY	cheney
CPDY	chopde
CPZ	gepje
CRAG	cherag
CRASKAYNT	chrescyntie
CRBL	cherbel
CRC	church
CRCYL	churchill
CRPY	cherepy
CRSKYNAY	chrescyntie
CRVBYNY	cherubini
CRVYC	scherwich
CRY	cherie
CRY	cherrie
CRYL	cheryl
CRYSKYNTY	chrescyntie
CRYSTAL	christall
CRYSYNTH	chrescyntie
CSBRV	chesbro
CS	ches
CSNY	chesney
CSNY	chesny
CSTR	chester
CTAL	chetal
CT	chet
CTVYN	chetwin
CVA	choua
CVA	chua
CV	cho
CV	choo
CV	chou
CV	chow
CV	chu
CVDHARY	choudhary
CVKRY	chokri
CVKSY	chokshi
CVLKA	chwolka
CVN	choon
CVNPYG	chunping
CVRN	chevron
CVSAK	chusak
CVVANAK	chovanak
CVY	choi
CVY	choy
CVYLR	schuyler
CYA	cheal
CYA	chia
CYAKY	chiaki
CYANG	chiang
CYBANSKY	cybanski
CY	chee
CY	chi
CYCSTR	chichester
CYK	cheek
CYK	chick
CYK	chik
CYKN	chickon
CYKRY	chickery
CYKY	cheeky
CYKZ	cheeks
CYLDZ	childs
CYLT	cheiltje
CYLTH	cheiltje
CYLTJ	cheiltje
CYLTJH	cheiltje
CYLY	chilly
CYLYJH	cheiltje
CYLYNGVRS	chillingworth
CYLYNGVRT	chillingworth
CYM	chiem
CYN	chien
CYN	chin
CYNN	chinen
CYNV	cheenu
CYP	chip
CYP	gepje
CYPLVYDN	schipluiden
CYPMN	cheapman
CYPN	scheepen
CYRAG	chirag
CYRAK	chirag
CYSM	chism
CYSMN	cheesman
CYSTY	chishtie
CYSVLM	chisholm
CYTA	chitta
CYTAM	cheetham
CYTAN	chetan
CYT	cheiltje
CYT	chet
CYTRDY	chitrady
CYTVVD	cheatwood
CYTVYN	chetwin
CYTYK	chittick
CYV	chiew
CYV	chiou
CYZVBA	chizoba
CYZV	chizu
CYZVRV	chizuru
DABAC	dubach
DABAS	dubuc
DABL	double
DABNY	dabney
DABS	dobbs
DABSVN	dobson
DABVS	dubose
DABVYS	dubois
DABYL	dubiel
DABYNSKY	dubinsky
DABYNSN	dobinson
DABYNSVN	dobinson
DABYNZ	dobyns
DADA	dada
DAD	daud
DADGYVN	dudgeon
DADH	dade
DADK	doddek
DADLY	dudley
DADS	dodds
D'A	dua
DADV	doggo
DADYR	dodier
DAF	duff
DAGAN	dagan
DAGAN	dugan
DAG	dag
DAG	dog
DAG	dug
DAGLY	dagley
DAGN	dodgen
DAGR	dugger
DAGRTY	daugherty
DAGRZ	doggers
DAGVAC	dogwatch
DAGZ	dogs
DAHAK	dahuk
DAHAML	duhamel
DAHN	duhon
DAHRTY	doherty
DAHVD	dahuk
DAHVK	dahuk
DAJ	daatje
DAJ	dodge
DAJYVN	dudgeon
DAKAS	doucas
DAK	doc
DAK	duc
DAK	duk
DAKHVRN	dockhorn
DAKLVZ	ducloz
DAKMN	duckman
DAKN	dokkene
DAKRYNG	duckering
DAKS	dax
DAKS	dox
DAKTRZ	doctors
DAKV	daco
DAKVRS	duckworth
DAKYNG	dawkins
DAKYNZ	dawkins
DAKZ	dykes
DALAJR	dalager
DALAN	dallan
DALAS	doulas
DALAYR	dallaire
DALBK	dalbec
DALBRGR	dulberger
DALBYR	dolbear
DAL	dahl
DAL	dal
DAL	dull
DALFR	dulfer
DALMN	dolman
DALMS	dolmas
DALMYYA	dalmia
DALNZ	dollens
DALRS	dolores
DALRYMPL	dalrymple
DALTVN	daulton
DALY	daley
DALY	dalley
DALY	dolly
DALY	dooley
DALYNAR	dolinar
DALYNGR	dollinger
DAMAR	dhamar
DAMBL	dumbbell
DAMLR	duemler
DAMPLTVN	dumpleton
DAMVN	damon
DAMVNTT	dumontet
DAMYAN	damian
DAMYANV	damiano
DAMYLA	djamila
DAMYNGS	domingues
DAMYNY	dominy
DAMYNYKAS	dominicus
DAMYTRV	dumitru
DAMYVN	damion
DANA	dana
DANALD	danald
DANA	thana
DANAVAN	donovan
DAN	dan
DANDAS	dundas
DAN	dohn
DAN	donn
DAN	dun
DANDY	dundee
DANFRD	dunford
DANFY	dunphy
DANG	dong
DANG	dung
DANGTAY	dongtai
DANGVY	dongwei
DANGYV	dongyu
DANGYVN	dungeon
DANHAM	dunham
DANH	dunne
DANJL	dangel
DANKAN	duncan
DANKV	danco
DANKV	danko
DANKY	dunki
DANLVP	dunlap
DANLY	donnelly
DANNBARGR	danenbarger
DANNLY	donnelly
DANR	donner
DANSMVR	dunsmore
DANSTR	dunster
DANSY	dancy
DANSYNG	dancing
DANTN	dunten
DANVAN	donovan
DANY	dani
DANY	donny
DANYDYN	dunedin
DANYL	daniel
DANYL	daniell
DANYL	danielle
DANYLSVN	danielson
DANYLV	danilo
DANYLZ	daniels
DANYS	danis
DANYYLS	daniels
DANZ	danz
DAPAY	dupuy
DAPNYK	doupnik
DAPRK	duparc
DAPRRY	duperre
DAPRY	dupree
DARANG	durrand
DARA	thara
DARBY	darby
DAR	durr
DARHAM	durham
DARL	darrell
DARLY	darley
DARLYNGTN	darlington
DARNAL	darnall
DARNL	darnall
DARNL	darnell
DART	dart
DARV	darrow
DARVN	doron
DARYGVS	darrigues
DARYL	daryl
DAS	das
DAS	doss
DASN	dawson
DASVN	dawson
DASYNG	dossing
DASYVK	doseok
DAT	daatje
DATH	daatje
DATJH	daatje
DATRY	datri
DATSVN	dotson
DATVN	dutton
DATVYT	duthoit
DATY	daatje
DATY	dottie
DAVAD	dawud
DAVARK	devarque
DAVBR	dauber
DAVD	daud
DAVD	dawood
DAVD	dawud
DAV	dov
DAV	dove
DAV	dow
DAVKNYZ	dawkins
DAVKYNZ	dawkins
DAVN	down
DAVNPRT	davenport
DAVNY	downey
DAVNYNG	dawning
DAVNYNG	downing
DAVRS	dovers
DAVRYN	daverin
DAVSAN	dawson
DAVS	dawes
DAVSN	dawson
DAVSVN	dawson
DAVT	dout
DAVVD	dawood
DAVVD	dawud
DAYAL	dial
DAYAN	dion
DAYAN	dione
DAYANYSYA	dionysia
DAYANYSYS	dionisios
DAYAZ	diaz
DAYBALA	dyballa
DAYBL	dibble
DAYCYNC	duyckinck
DAY	day
DAY	die
DAYDRYC	diedrich
DAY	duy
DAYK	dike
DAYKSVN	dixon
DAYKY	dickey
DAYKYNK	duyckinck
DAYKYNZ	dykins
DAYLAYGAN	dilligan
DAYLVN	dillon
DAYMND	diamond
DAYN	dwain
DAYN	dwaine
DAYR	dayr
DAYRDRYK	dierderick
DAYR	dyer
DAYRKTVR	director
DAYRT	dievertje
DAYS	dais
DAYT	dwight
DAYVD	daud
DAYVRJH	dievertje
DAYVRJH	divertje
DAYVRT	divertje
DAYVRTH	divertje
DAYVRTJ	dievertje
DAYVRTJ	divertje
DAYVRYA	dauria
DAYVVN	dauwen
DAYVYN	divine
DBATVNYA	debathonia
DBLR	deibler
DBYT	debathe
DDFYLD	deadfield
DDJN	dudgeon
DDRYK	dedrick
DDY	dady
DFRVY	defroy
DGLY	dagley
DGRAF	degraff
DGRF	degraff
DGRLVND	degerlund
DGVTARDY	degotardi
DHA	duha
DHAMAR	dhamar
DHNR	dehner
DHNRT	dehnert
DHVK	dahuk
DJAMYLA	djamila
DJLY	dagley
DKAN	dekan
DKK	dekok
DKLRK	declerck
DKR	decker
DKSTR	dexter
DKYAH	zakiyyah
DKY	zaki
DK	zeke
DLAL	dalal
DLANY	delaney
DL	del
DLH	doleh
DLMAN	dellmann
DLNY	delaney
DLRD	dallard
DLRYV	delrio
DLTN	dilten
DLTVVYA	deltuvia
DLVRA	deloura
DLVRYZ	deloris
DLVYS	delouise
DLY	dalie
DLYKATNY	delikatny
DLYS	dellis
DLYSYV	delisio
DMA	dema
DMA	dima
DMKAK	demcak
DMKH	demke
DML	dehmel
DMLR	demler
DMN	demon
DMPSTR	dempster
DMR	dhamar
DMRZ	demers
DMSQ	dimashq
DMYLA	djamila
DMYNYSVS	dominicus
DMYS	damis
DNALD	donald
DNAQY	donaghy
DNAVLT	denault
DN	den
DNDLR	dandler
DN	donn
DNDRYJ	dandridge
DNG	deng
DNHAM	denham
DNJVR	dangoor
DNKVALTR	denkewalter
DNKYND	danekind
DNL	dennell
DNMN	denman
DNNL	dennell
DNRYJ	dandridge
DNSR	dancer
DNTVN	denton
DNV	deno
DNVKS	denux
DNYH	danih
DNYL	daniel
DNYLZ	daniels
DNYNG	denning
DNYS	danis
DNYSVN	dennison
DRABK	drabek
DRADR	drader
DRAGAN	dragan
DRAGANYS	draganis
DRAGN	dragon
DRAGR	druger
DRAKMN	drukman
DRAL	dralle
DRALT	drolet
DRAMATYS	dramatis
DRAM	drum
DRAP	drop
DRAPR	draper
DRAST	droste
DRATMN	dratman
DRATY	dorathee
DRAVN	drown
DRAVR	drover
DRAYNH	draine
DRAYR	dreyer
DRBS	drebes
DRBY	derby
DRCMN	drachman
DRDH	darde
DRG	drag
DRGVMYR	dragomir
DRGVN	dragon
DRGVNS	dragons
DRK	derek
DRKSL	drexel
DRMVT	dermott
DRNAL	darnall
DRNK	drnek
DRNTR	drenter
DRSNR	dressner
DRTCN	dortchen
DRTH	doortje
DRV	derro
DRV	drew
DRVDYNG	druding
DRVDYS	drudis
DRVMAND	drummond
DRVMR	droomer
DRVNY	drune
DRVNYS	dervenis
DRVR	dror
DRVT	drewett
DRVYK	drevik
DRVYT	drewett
DRVZN	drosehn
DRYDJY	dridge
DRYFVS	dreyfus
DRYJR	driedger
DRYK	derrick
DRYK	drake
DRYM	dream
DRYMR	dreamer
DRYMZ	dreams
DRYNKS	drinks
DRYNZ	derienze
DRYR	dreier
DRYRY	dreary
DRYS	drees
DRYSKVL	driscoll
DRYSKYL	driskill
DRYV	drew
DRYV	drewe
DRYVT	drewett
DRYXA	drikha
DS	des
DSL	desle
DSMVLYNZ	desmoulins
DSMVND	desmond
DSMYT	desmet
DSNVYRZ	desnoyers
DSRAZYRS	desrosiers
DSRVZYRZ	desrosiers
DSTLY	desotelle
DSVTV	desoto
DTLFS	detlefs
DTMN	dettman
DTRYJ	deatherage
DTS	datz
DTVYLR	detweiler
DVA	dua
DVAK	dueck
DVALYBAY	dowaliby
DVAN	duan
DVANYR	douanier
DVAR	duerr
DVARTH	duarte
DVAYKYNK	duickinck
DVBAY	dubay
DVBRATZ	dobbratz
DVBRYDJ	dubridge
DVBRYKYN	dobrikin
DVBRYZ	dubris
DVBSVN	dobson
DVBVYS	dubois
DVBYNSVN	dobinson
DVBYNYN	dubinin
DVBYR	dubear
DVCARM	ducharme
DVCAYLARD	duchaylard
DVCT	duchet
DVCYNC	duickinck
DVDA	duda
DVDAMANY	dodamani
DVD	daud
DVDGVN	dudgeon
DVDJ	dodge
DVDL	dodell
DVDLY	dudley
DV	doe
DV	dou
DVFVR	dufour
DVGAN	dogan
DVGAN	dugan
DVG	doug
DVGYVN	dudgeon
DVHA	duha
DVHH	duha
DVHRTY	doherty
DVHVR	douhour
DVHYRST	dewhirst
DVJN	dudgeon
DVK	doake
DVK	doc
DVLAN	dolan
DVL	dole
DVLKYA	zuleika
DVLMAN	dolman
DVLR	dowler
DVLY	dooley
DVLYN	dolin
DVMBA	domba
DVM	daum
DVM	domm
DVMN	domen
DVMNYKV	domenico
DVMYKV	domeyko
DVMYKZ	doumakes
DVMYNGV	domingo
DVMYNYKAS	dominicus
DVMYNYK	dominic
DVMYNYK	dominick
DVMYNYKS	dominicus
DVMYNYKYVS	dominicus
DVMYNYN	dominion
DVMYNYVS	dominicus
DVNACY	donachie
DVNA	dona
DVNALD	donald
DVNAT	donath
DVNATV	donato
DVNATY	donati
DVNAY	dunae
DVN	deven
DVN	doan
DVNG	dong
DVNHAM	dunham
DVNKN	duncan
DVNLY	donnelly
DVNPK	devenpeck
DVNPYK	devenpeck
DVNS	downes
DVNTSK	donetsk
DVNVAN	donovan
DVNYNY	donini
DVNYS	theunis
DVPALM	depalm
DVPLR	doppler
DVPLT	doppelt
DVPRY	duprie
DVPYVYS	dupuis
DVRA	dora
DVRAND	durand
DVRAND	durrand
DVRAN	doran
DVRAN	doron
DVRAPT	durupt
DVRAS	duross
DVRASY	dorathee
DVRATH	dorathee
DVRATY	dorathee
DVRAVKS	devereaux
DVRAYA	thurayya
DVRAZYV	dorazio
DVRCAK	dorchuck
DVRCN	dortchen
DVRDAL	dordal
DVRFMAN	dorfman
DVRHAM	durham
DVRKN	dorken
DVRKYN	dworkin
DVRL	dorel
DVRLD	thurlede
DVRMA	dorma
DVRND	durand
DVRND	durrand
DVRN	doren
DVRN	dorn
DVRRANS	durrance
DVRST	dorsett
DVRSY	dorsey
DVRSY	dorthy
DVRTCN	dortchen
DVRT	doortje
DVRTH	doortje
DVRTJ	doortje
DVRTJH	doortje
DVRTVN	thornton
DVRTY	doortje
DVRTY	dorathee
DVRVC	duroch
DVRVTY	dorothy
DVRVYN	dorwin
DVRY	dorie
DVRYNDA	dorinda
DVRYS	dooris
DVRYS	doris
DVRYSVMY	doraiswamy
DVS	duse
DVSKV	dusko
DVSN	dusen
DVSTALYK	dostalik
DVSTY	dusty
DVTA	dutta
DVVAYKYNK	duickinck
DVVL	dovell
DVY	doi
DVYKYNK	duickinck
DVYKYNK	duyckinck
DVYN	deven
DVYNDR	devender
DVYNY	deviney
DVYNYNG	duening
DVYR	duerr
DVYSR	devisser
DVYT	dwight
DVYTV	devito
DVYVYR	duvivier
DVYYKYNK	duickinck
DVZAT	duzat
DVZYYR	dozier
DYAB	diab
DYA	diaa
DYA	diya
DYALA	diyala
DYAMANTARAS	diamantaras
DYAMDY	diomedea
DYAMVND	diamond
DYANA	diana
DYAN	diane
DYAZ	diaz
DYBAT	debathe
DYBATH	debathe
DYBATVNYA	debathonia
DYB	dib
DYBL	deibele
DYBT	debathe
DYBTVNYA	debathonia
DYBV	debow
DYBYT	debathe
DYCYR	deicher
DYDA	rida
DY	day
DY	dea
DY	dei
DYDRYSZ	diederichs
DYDRYX	diedrich
DYDYRYCS	diederichs
DYGAN	degen
DYGAZMN	deguzman
DYGH	dighe
DYGNARV	degennaro
DYGRAF	degraff
DYGRF	degraff
DYGRV	degraw
DYGV	diego
DYGVYD	digweed
DYKANYNK	deconinck
DYKAVTY	decouty
DYK	dick
DYK	dik
DYKL	dekel
DYKNS	dykins
DYKNZ	dickens
DYKNZ	dykins
DYKSAY	dixie
DYKS	dix
DYKSN	dixon
DYKSTRA	dikstra
DYKSVN	dixon
DYKSVN	dixson
DYKV	dickow
DYKV	dico
DYKY	dickey
DYKY	dicky
DYKYNZ	dykins
'DYL	adil
DYLAN	dilan
DYLAYR	delaere
DYL	dil
DYLMA	dilemma
DYLN	dillon
DYLNY	delaney
DYLR	diller
DYLVRS	dillworth
DYLY	dailey
DYLY	dealy
DYLYNGR	dellinger
DYLYNGTN	billington
DYLYP	dileep
DYLYP	dilip
DYLYV	deleeuw
DYMAD	dima
DYMA	dema
DYMA	dima
DYMARS	demars
DYMARST	demarest
DYMARYP	dimaryp
DYMAS	dimashq
DYMASK	dimashq
DYM	dame
DYMN	damon
DYMRS	demers
DYMSAK	dimashq
DYMVK	dimock
DYMYNG	deeming
DYMYTAR	dimitar
DYMYTRY	dimitri
DYMYTRYS	dimitris
DYMYTRYV	demetrio
DYMYTRYV	demetriou
DYMYTRYVS	dimitrios
DYNA	dina
DYNA	dinah
DYNA	dyna
DYNAMYT	dynamite
DYNBYM	denebeim
DYN	dean
DYN	din
DYN	dinn
DYNG	ding
DYNGLV	deangelo
DYNGSVR	dingsor
DYNGY	dinghy
DYNGY	dingyi
DYNL	dennell
DYNLR	dinler
DYNN	dineen
DYNPYK	devenpeck
DYNR	deaner
DYNS	dinesh
DYNS	dinse
DYNSMVR	dinsmoor
DYNT	dint
DYNV	dinno
DYNY	dini
DYNYNGR	deininger
DYPAK	dipak
DYPAYVLA	depaola
DYPAYVLV	dipaolo
DYPBVY	dipboye
DYPLD	dippold
DYPRSYV	depressive
DYPRTR	deporter
DYPYTRV	dipietro
DYR	dare
DYR	dayr
DYR	dear
DYRDRK	dierderick
DYRDRYK	dierderick
DYRK	derrick
DYRK	dierk
DYRKS	dirks
DYRVKV	dirocco
DYRVRTJ	dievertje
DYSANTV	desanto
DYSAV	dishaw
DYSAY	desai
DYS	dees
DYSGY	disegi
DYSMVND	desmond
DYSNT	dessent
DYSTL	distel
DYTJY	daatje
DYTMAR	dietmar
DYTR	diether
DYTVRZ	detours
DYTVTALA	ditutala
DYVA	dua
DYVAKARVNY	divakaruni
DYVANATAN	devanathan
DYVAN	dewan
DYVAR	dewar
DYVAYN	devine
DYVAYN	divine
DYVAYZR	devisser
DYVHA	duha
DYVN	deven
DYVNH	dionne
DYVNPK	devenpeck
DYVNYDA	dionida
DYVRT	dievertje
DYVRT	divertje
DYVRTH	dievertje
DYVRTJ	divertje
DYVRTJH	dievertje
DYVRTJH	divertje
DYVVSR	devisser
DYVYA	divya
DYVY	davie
DYVYD	davi
DYVYD	david
DYVYD	davide
DYVY	dewey
DYVYDSVN	davidson
DYVYDYAN	davidian
DYVYLDH	dewilde
DYVYS	divis
DYVYSN	davison
DYVYSVN	davison
DYVYT	dewitt
DYYALA	diyala
DYZNY	disney
DYZR	devisser
DYZVN	dizon
DZ	des
DZGAGNH	desgagne
FABLR	fubler
FABRH	fabre
FABRV	fabro
FABRYS	fabris
FABYANV	fabiano
FACS	fuchs
FAD	fahd
FADL	fadl
FADNBRG	fudenberg
FADVR	fodor
FADYLA	fadila
FADYL	fadil
'FAF	afaf
FAGAN	fagan
FAGANS	fagans
FAJN	fagen
FAJYVAR	fujiwara
FAKS	fox
FALCVK	falchuk
FALK	falk
FALKNR	faulkner
FALKRSVN	fulkerson
FALKV	falco
FALKVNR	falconer
FALN	fullen
FALSAM	folsom
FALTAK	foltak
FALTLS	faultless
FALTVN	fulton
FALVN	fallon
FALY	foley
FALYVT	folliot
FALZ	fales
FAMYVS	famus
FANDRYC	fandrich
FANG	phuong
FANGVS	fungus
FANTS	fontes
FARA	farah
FARAG	farag
FARAGV	farago
FARAT	furat
FARKAS	farkas
FARL	farrell
FARLY	farley
FARMR	farmer
FARSBRG	forsberg
FARST	forrest
FARTK	furtek
FARVANYA	farwaniyah
FARVANYAH	farwaniyah
FARVGYA	farrugia
FARVK	farooq
FARVK	farouk
FARVQ	farooq
FARVZ	fairuz
FARYD	farid
FARY	furey
FARYHA	fariha
FARYVR	farrior
FASBRG	fossberg
FAS	fash
FAS	foss
FASL	fasel
FATYMA	fatima
FATYS	fotis
FAVAZ	fawaz
FAVL	fauvel
FAVNS	faunce
FAVNS	fownes
FAVST	faucett
FAVST	fausett
FAVST	faust
FAVST	foust
FAVZYA	fawziyya
FAVZY	fawzi
FAVZYYA	fawziyya
FAXRY	fakhri
FAYF	fife
FAYK	fike
FAYLS	fils
FAYN	fayne
FAYNK	finke
FAYNLY	finley
FAYNRTY	finerty
FAYNSTVN	finestone
FAYNTVN	finton
FAYRBANK	fairbank
FAYRVZ	fairuz
FAYT	fayette
FAYYZ	fayiz
FAYZA	faiza
FAYZ	faiz
FAYZ	fayiz
FAYZL	faizel
FAZA	faiza
FAZ	faiz
FAZL	faizel
FAZYA	fawziyya
FAZY	fawzi
FAZY	fuzzy
FBRV	fabbro
FCNR	fechner
FDL	fadl
FDR	feather
FDR	feder
FDRL	federle
FDRMN	federman
FDVR	fedor
FDYLA	fadila
FDYL	fadil
FHD	fahd
FHT	fahd
FK	fac
FLAGLLY	flaglelee
FLAHRTY	flaherty
FLAKYGR	fluckiger
FLARDYNGA	flardinga
FLAT	fallate
FLAT	flat
FLAVKA	felawka
FLAY	fly
FLAYGYR	flygare
FLAYS	felice
FLDMAN	feldman
FLDMAR	feldmar
FLDMN	feldman
FLDR	felder
FLDSPAR	feldspar
FLJ	fletje
FLK	fleck
FLKYNZ	folkins
FLMR	flemmer
FLSTY	flesti
FLTH	fletje
FLTJ	fletje
FLTJH	fletje
FLTYV	felteau
FLVCH	fluche
FLVDYN	flodin
FLVRA	flora
FLVR	flor
FLVR	fluur
FLVRK	florek
FLVRNS	florence
FLVRS	flores
FLVRY	fuloria
FLVRYN	florian
FLVRZ	flores
FLVT	flute
FLVVRZ	flowers
FLVYD	floyd
FLYJH	fletje
FLYKS	felix
FLYKYNGR	flickinger
FLYM	flame
FLYMYNG	fleming
FLYNDRZ	flinders
FLYNT	flint
FLYNY	fellini
FLYSZ	felices
FLYVRY	fleury
FLYZARDV	felizardo
FMMTH	femmetje
FMT	femmetje
FMTJ	femmetje
FMYA	femea
FNCARC	fenchurch
FNDR	fender
FN	fan
FN	fenn
FNG	feng
FNGR	fanger
FNR	fenner
FNSKY	fenske
FNTVN	fenton
FNTYMAN	fentiman
FNVYK	fenwick
FNY	fane
FNYS	fenyes
FRA	fera
FRAGVRGYA	frageorgia
FRAM	frahm
FRAMSAN	fromson
FRAMSVN	framson
FRANDSN	frandsen
FRAN	ferran
FRANGAKYS	frangakis
FRANKL	fraenkel
FRANKL	frankel
FRANKLYN	franklin
FRANKV	franco
FRANKV	franko
FRANKVY	francoys
FRANKVYS	francoys
FRANKVYZ	francoys
FRANS	france
FRANSR	franser
FRANSSYDTJ	franscyntje
FRANSVYZ	francoys
FRANSYKA	fransiska
FRANSYNTAY	francyntie
FRANSYNTH	franscyntje
FRANSYNTJH	franscyntje
FRANSYNTY	francyntie
FRANSYNTYH	francyntie
FRANSYNTZ	franscyntje
FRANSYSKA	francisca
FRANSYSKA	fransiska
FRANSYSKAS	frnaciscus
FRANSYSKVS	frnaciscus
FRANSYSYVS	frnaciscus
FRANTYSK	frantisek
FRANTZN	frantzen
FRAQ	farag
FRARY	ferrari
FRASR	fraser
FRAST	frost
FRASTY	frosti
FRAYDA	frieda
FRAYDMAN	friedman
FRAYDMN	friedman
FRAYDY	friday
FRAY	fry
FRAYGRSA	fritgersa
FRAYTGRSA	fritgersa
FRAZR	frazer
FRAZYR	frazier
FRAZYYR	frazier
FRDA	fredda
FRDAYNND	ferdinand
FRD	fred
FRDKYN	fradkin
FRDRKYNG	frederking
FRDRYK	frederick
FRDRYK	frederik
FRDRYK	fredrick
FRDRYK	fredrik
FRDRYKV	frederico
FRDT	fredette
FRDYA	frieda
FRDY	freddie
FRDY	freddy
FRDYG	ferdig
FRG	farag
FRGT	forget
FRGVSN	ferguson
FRH	farah
FRJ	farag
FRJN	fragen
FRLANG	furlong
FRLY	farley
FRM	frome
FRNANDS	fernandes
FRNANDV	fernando
FRNANDZ	fernandez
FRNASYSKAS	frnaciscus
FRNASYSKAZ	frnaciscus
FRNC	french
FRNK	franck
FRNK	franke
FRNKH	francke
FRNKL	frankel
FRNKL	frenkel
FRNKLYN	franklin
FRNKSVN	frankson
FRNKVYS	francoys
FRNKVYZ	francoys
FRNSAYNT	franscyntje
FRNS	furness
FRNSNYT	francyntie
FRNSNYT	franscyntje
FRNSVYS	francois
FRNSYNTY	francyntie
FRNSYSKA	francisca
FRNSYSKA	fransiska
FRNZL	frenzel
FRQ	farag
FRR	farer
FRSR	fraser
FRTYK	fertik
FRVANYAH	farwaniyah
FRVANYH	farwaniyah
FRVK	farooq
FRVK	farouk
FRVMYN	fromhein
FRVNYAH	farwaniyah
FRVZ	furrows
FRYBRG	freeburg
FRYDA	frieda
FRYDBRGR	friedberger
FRYD	farid
FRYDGYR	fridgeir
FRYDH	fariha
FRYDL	friedl
FRYDMAR	friedmar
FRYDMN	freedman
FRYDMN	friedman
FRYDRYK	fredrick
FRYDYN	freidin
FRY	ferree
FRY	free
FRYHA	fariha
FRYKS	frix
FRYLND	freeland
FRYLYNG	freiling
FRYLYNGR	freilinger
FRYLZ	freels
FRYMAL	freemal
FRYMVT	freimuth
FRYNGTVN	ferrington
FRYNK	frink
FRYNK	phrink
FRYR	ferrier
FRYR	freer
FRYRMAT	freyermuth
FRYS	ferris
FRYS	fries
FRYS	friess
FRYTAG	freitag
FRYTAS	freitas
FRYT	frith
FRYTGRSA	fritgersa
FRYTN	fritton
FRYTS	frits
FRYTV	freeto
FRYTVL	fretwell
FRYTZYVS	fritzius
FRYVALD	freiwald
FRYVVGL	freivogel
FRYZ	freese
FRYZR	fraser
FRYZR	frazer
FSDAL	fosdal
FST	fast
FSYG	fasig
FTC	fetch
FTCN	fetchen
FTRA	fetra
FTR	fetter
FVD	fude
FVJY	fuji
FVJYTA	fujita
FVJYVKA	fujioka
FVKV	phoque
FVLDZ	foulds
FVLGAM	fulghum
FVLKANYS	fulconis
FVLK	foulk
FVLKS	fowlkes
FVLMN	fullman
FVLN	fullen
FVLR	fowler
FVLR	fuller
FVLY	foley
FVMRTVN	fumerton
FVNDAL	fundal
FVNDV	fondo
FVNGN	fongen
FVNG	phong
FVNKY	funky
FVNTNVT	fontenot
FVN	van
FVNYVK	foniok
FVRBS	forbes
FVRBZ	forbes
FVRD	forde
FVRDHAM	fordham
FVRDSANDN	furdesanden
FVRJY	forgy
FVRK	fork
FVRLANG	furlong
FVRMN	forman
FVRMN	fuhrmann
FVRNR	fournier
FVRNY	fourney
FVRNY	fournie
FVRNYR	fournier
FVRR	forrer
FVRRV	forero
FVRSAYT	forsyth
FVRSAYT	forsythe
FVRSBLAM	forsblom
FVRSBRG	forsberg
FVRS	force
FVRSYL	forsale
FVRT	forte
FVRTS	forts
FVRY	furey
FVSNG	fosseng
FVT	foot
FVTRR	fuetterer
FVTS	fouts
FVTYNVS	fotinos
FVY	fui
FVYS	fuess
FVYY	fui
FVZARD	fozzard
FVZY	fawzi
FVZYH	fawziyya
FXRYA	fakhriyya
FXRY	fakhri
FXRYYA	fakhriyya
FXYR	fakhri
FYABAN	fiabane
FYAKSY	phiaxay
FYASKVNARV	fiasconaro
FYBR	faber
FYDALGV	fidalgo
FYDL	fidel
FYDLR	fidler
FYDVR	fedor
'FYF	afif
FYGARD	figard
FYGVRA	figura
FYHAN	feehan
FYK	fick
FYKS	fix
FYLAKS	phlux
FYL	feil
FYLK	fielek
FYLPAT	philpot
FYL	phil
FYL	phill
FYLPS	phillips
FYLR	feiler
FYLVS	phylos
FYLVZ	fellows
FYLYAS	filias
FYLY	feely
FYLYP	philip
FYLYPS	philips
FYLYPS	phillips
FYLZ	phils
FYMTJH	femmetje
FYMYJH	femmetje
FYNAN	feenan
FYNAN	finan
FYNC	finch
FYN	fin
FYN	finn
FYNK	fink
FYNKL	finkle
FYNLY	finelli
FYNLY	finlay
FYNLY	finley
FYNSTAD	finstad
FYNY	feeney
FYNYN	finnin
FYNYS	fennis
FY	phi
FYPS	phipps
FYRBNKS	fairbanks
FYRBRYN	fairbairn
FYR	fair
FYRHRST	fairhurst
FYRMA	firma
FYRN	fearn
FYRVDR	fairweather
FYRVK	farouk
FYRVZ	fairuz
FYRVZ	phiroze
FYSBYN	fishbein
FYS	face
FYS	fish
FYSK	fisk
FYSR	fisher
FYTA	fitta
FYTC	fitch
FYTZJRALD	fitzgerald
FYTZVL	fitzwell
FYVR	fiore
FYVSTL	feustel
FYZA	faiza
FYZ	faiz
FYZH	faiza
FYZL	faizel
FZYA	fawziyya
GABA	gaba
GABARA	gabara
GABBL	gobble
GABLR	gabler
GABRYLH	gabriele
GABRYLH	gabrielle
GABRYYLSVN	gabrielsson
GABVR	gabor
GABYN	gubbin
GACR	goucher
GADBRY	gadbury
GADBT	godbout
GADBVRY	gadbury
GADBVYS	gadbois
GADFRVYD	godfroid
GADFRY	godfrey
GADGL	gudgel
GADMN	godman
GADRV	gaudreau
GADSN	godson
GADSVARD	goudswaard
GADVYN	godewyn
GADY	gadi
GADYJN	goddijn
GADYL	gadil
GAF	goff
GAF	gough
GAFNY	gaffney
GAFRAN	ghufran
GAFYN	gaffin
GAGNH	gagne
GAHRTY	gaherty
GAJNH	gagne
GAJR	goodger
GALA	galea
GALAGHR	gallagher
GALAGR	gallagher
GALAHAD	galahad
GALAN	gallun
GALANT	gallant
GALATYN	gallatin
GALAVY	galloway
GALBAVAY	galbavy
GALC	gulch
GALDN	goulden
GAL	gaal
GAL	gael
GAL	gale
GAL	gull
GALJ	gulledge
GALKV	galko
GALN	galen
GALP	gallop
GALPYN	galpin
GALT	gullett
GALV	galo
GALVLA	gallula
GALVSN	gulovsen
GALVVY	galloway
GALVY	galloway
GALYBRT	galibert
GALY	gali
GALY	galley
GALY	galli
GALY	gully
GALYLA	galila
GALYLH	galila
GALYLH	galileo
GALYTY	gallaty
GALYVN	gallion
GALYZYA	galizia
GAMAK	gamache
GAMAL	gamal
GAMBYNV	gambino
GAML	gamal
GAML	gammel
GAMRV	gamero
GAMRVS	gummerus
GAMVN	gammon
GAMYJ	gamage
GAMYSH	galmiche
GANAPATY	ganapathy
GANAR	gunnar
GANATRA	ganatra
GANAVAN	gunawan
GANDLC	gundlach
GANDRSVN	gunderson
GANDRZYK	gonderzik
GANDVRP	gunthorpe
GANDY	gandy
GAN	gan
GANG	gang
GANG	gung
GANGVLY	gangolli
GANL	gunnel
GANRVS	gunnerus
GANS	gans
GANSVN	gunson
GANTRAM	guntram
GANTR	ganter
GANTR	gunter
GANTR	gunther
GANTRP	gunthorpe
GANTRT	gantert
GANTVRP	gunthorpe
GANTVRPH	gunthorpe
GANTY	ganti
GANVN	gannon
GANVYL	gonville
GANYR	gonyer
GANYSAN	ganesan
GANZAK	ganzak
GANZALZ	gonzalez
GAPTA	gupta
GAPYSTY	gopisetty
GARADVAN	gurudevan
GARAFALV	garofalo
GARANS	garance
GARBH	garbe
GARBY	garbee
GARDNR	gardner
GARDYNR	gardner
GARFYLD	garfield
GARFYNKL	garfinkel
GARLYK	garlick
GARMZ	garms
GARN	garon
GARNR	garner
GARNT	garnett
GARNY	gurney
GARSKY	gursky
GARSS	garces
GARSVL	garshol
GARSYA	garcia
GART	garrett
GARTMN	gartmann
GARTRYJ	gutteridge
GARTYN	gartin
GARVD	garrod
GARVFALV	garofalo
GARVLA	gurrola
GARVTV	garruto
GARYK	garlick
GARYK	garrick
GARYS	gaeris
GARYTV	garito
GASARD	gossard
GAS	gus
GASKAT	guscott
GASKVN	gascoyne
GASKVYN	gascoyne
GASKVYYN	gascoyne
GASKYN	gaskin
GASKYNZ	gaskins
GASLR	gashler
GASLR	gossler
GASLYK	guslick
GASLYNG	gosling
GASPAR	gaspar
GASPR	gasper
GASTA	gosta
GASTAVS	gustavus
GASTAVVS	gustavus
GASTLAV	gostelow
GASTLV	gostelow
GASTYLV	gostelow
GASTYN	gostin
GASTYNYV	gastineau
GASVL	goswell
GASY	gussie
GASYK	gasic
GASYNK	gossink
GATA	gatta
GAT	gat
GAT	gaut
GATHARD	gotthard
GATKVMB	gatcombe
GATLYB	gottlieb
GATLY	gateley
GATLYN	gatlin
GATMN	gutman
GATMN	gutmann
GATRYJ	gutteridge
GATSF	gotseff
GATS	gates
GATS	gotts
GATVYN	gutwein
GATYS	gattis
GATYZ	gattis
GATZ	gatz
GATZVYLR	gutzwiller
GAVAZNY	gavazzeni
GAV	gao
GAVRD	goverd
GAVR	gower
GAVTYR	gauthier
GAVYNDAN	govindan
GAVYND	govind
GAVYN	gavin
GAYA	gaya
GAYAT	guyatt
GAYBS	gibson
GAYDA	gayda
GAYDRY	guidry
GAYDVAL	gidewall
GAYDV	guido
GAYGL	giegel
GAY	guy
GAYLR	gayler
GAYLVN	guillon
GAYMN	gayman
GAYMVND	guimond
GAYNL	gaynell
GAYNVR	gainor
GAYNVR	gaynor
GAYR	guyer
GAYT	guyatt
GAYVN	gawne
GAYYTZ	gaetz
GAZK	guzek
GAZMN	guzman
GBY	gabi
GDARD	goddard
GDBRY	gadbury
GDK	gedeck
GDRALT	gaudrault
GDR	goderre
GDYRA	qadira
GDYRH	qadira
GDYR	qadir
GDYS	geddis
GF	goff
GFRAN	ghufran
GLAS	glass
GLASKV	glassco
GLASYR	glacier
GLASYYR	glacier
GLATZ	glatz
GLAYR	gloyer
GLDASTYYN	goldsteen
GLDBRG	goldberg
GLDBRGR	goldberger
GLDFSMAN	geldefsman
GLDFSMN	geldefsman
GLDFVT	goldfoot
GLD	gold
GLDKMP	goldkamp
GLDMN	goldman
GLDR	golder
GLDYNG	golding
GLDZMN	geldefsman
GLDZVRSY	goldsworthy
GLF	gulf
GL	gul
GLNDVRF	glandorf
GLN	glenn
GLRYK	gellrich
GLS	glass
GLSYRZ	glaciers
GLTR	gelter
GLVB	golub
GLVJ	gloege
GLVRYA	gloria
GLVVY	galloway
GLYB	ghalib
GLYC	gleich
GLYCMN	gleichman
GLYK	gleick
GLYKSMN	glicksman
GLYN	glynn
GLYNZ	glenns
GLYSVN	gleason
GLYVS	gleaves
GLYZR	gleizer
GMBL	gamble
GMG	gamage
GML	gamal
GML	gemmell
GMYJ	gamage
GNAGY	gnagy
GNKS	genks
GNVSYS	gnosis
GNYSYLDA	gnishilda
GNZALS	gonzales
GNZALS	gonzalez
GNZALZ	gonzales
GNZALZ	gonzalez
GNZ	genks
GPH	gepje
GPJ	gepje
GRAB	grubb
GRABNAR	grabnar
GRABN	graben
GRABYNR	grabiner
GRAD	grad
GRAF	graf
GRAFT	graft
GRAG	grog
GRAGTY	geraghty
GRAHAM	graham
GRAHAM	grahame
GRAH	grah
GRAHRNA	grahorna
GRALYN	gralian
GRAMSS	gramsas
GRANBRGR	grunberger
GRANDASTRVM	grundstroem
GRAND	grande
GRAN	gruhn
GRANTAM	grantham
GRANT	grant
GRANVYN	granvin
GRANYT	granite
GRANZYV	granzeau
GRARDYN	gerardin
GRASKYN	gruskin
GRASR	grosser
GRATR	grater
GRAV	grau
GRAV	graw
GRAV	grov
GRAV	grove
GRAYM	grimme
GRAYNGR	grainger
GRAYSLDYZ	griseldis
GRAYSYLD	grishilde
GRAYVAS	grivas
GRAYY	graae
GRAYYNGR	grainger
GRAYYV	grieve
GRBS	gerbes
GRBYAH	gharbiyah
GRBYH	gharbiyah
GRDAN	gordan
GRDN	gorden
GRDNR	gardner
GRDY	grady
GRFYT	graphite
GRG	garg
GRG	greg
GRG	gregg
GRGVR	gregoire
GRGVR	gregor
GRHARD	gerhard
GRHART	gerhardt
GRHART	gerhart
GRJVAYSN	graduation
GRKV	greco
GRL	girl
GRLY	gurley
GRLYK	garlick
GRMAK	germack
GRMBAN	gremban
GRM	gorm
GRNANDR	grenander
GRND	grand
GRNDMSTR	grandmaster
GRNDYDYR	grandidier
GRN	gran
GRNGR	granger
GRNJR	grainger
GRNJR	granger
GRNLY	granli
GRNSYNG	grensing
GRNT	grant
GRNVYL	grenville
GRNYCR	granicher
GRNY	gurney
GRQTY	geraghty
GRSAPH	gersappe
GRSDVRF	gersdorf
GRS	gerth
GRS	grass
GRSLDYS	griseldis
GRSR	graser
GRSTL	gerstel
GRSTY	grasty
GRSTYNN	grasteinen
GRTA	gretta
GRTCN	gretchen
GRT	gareth
GRT	gerth
GRTRVD	gertrude
GRTRVYD	geertruyd
GRVBY	groebe
GRV	grove
GRVGVRY	gregoire
GRVHVL	grohol
GRVLAYT	geervliet
GRVLYT	geervliet
GRVM	groom
GRVNR	groner
GRVNVALD	grunewald
GRVNYNK	groenink
GRVS	groce
GRVSJVHAN	grossjohann
GRVSK	grosek
GRVSR	grosser
GRVSY	grosse
GRVT	groat
GRVT	grout
GRVTHAVS	grothause
GRVVR	grover
GRVVY	groovy
GRVYNCM	gorinchem
GRVYN	gruen
GRVYNLND	groenland
GRVYNVLD	groenveld
GRYBH	gharbiyah
GRYBL	gribble
GRYBYH	gharbiyah
GRYF	greiff
GRYF	griff
GRYFR	graifer
GRYFR	greifer
GRYFR	griefer
GRYFY	griffy
GRYFYS	griffis
GRYFYTS	griffiths
GRYFYTZ	griffiths
GRYG	greig
GRY	gray
GRYGR	grieger
GRYGVR	gregor
GRYKV	greco
GRYLK	grilk
GRYLNBK	grillenbeck
GRYNBRG	greenberg
GRYNDLY	grindley
GRYNG	gerringe
GRYNGH	gerringe
GRYN	green
GRYNGR	grainger
GRYNHAM	grinham
GRYNJ	gerringe
GRYNJR	grainger
GRYNSVN	grinsven
GRYNVALD	greenwald
GRYNV	greenough
GRYNVP	greenop
GRYNVVD	greenwood
GRYNYAS	greanias
GRYNYJ	greenidge
GRYPNKRL	griepenkerl
GRYR	greer
GRYSAYLD	grishilde
GRYS	grace
GRYSLD	grishilde
GRYSLDYS	griseldis
GRYSMVR	grismore
GRYSR	graser
GRYST	grist
GRYSVALD	griswald
GRYSVLD	griswold
GRYSVN	greyson
GRYSYLD	grishilde
GRYSYLDH	grishilde
GRYT	grit
GRYTS	gerritse
GRYTZ	gritz
GRYTZN	gerritzon
GRYTZVN	gerritzon
GRYVL	greuel
GRYVLYT	geervliet
GRYVNVD	greewnood
GRYYN	green
GRYYNVALD	greenwald
GRYZLY	grizzly
GRYZVN	gerritzon
GSAN	ghassan
GS	gass
GSKVYN	gascoyne
GSKVYNH	gascoyne
GSKYN	gaskin
GSKYNS	gaskins
GSKYNZ	gaskins
GSTAVVS	gustavus
GST	guest
GSTL	gastli
GTYS	gettys
GVADA	gouda
GVANG	guang
GVAN	gowan
GVAN	guan
GVANYAV	guanyao
GVARD	goward
GVBL	goble
GVBYN	gubbin
GVCAN	guochun
GVDA	godau
GVDA	gouda
GVDA	goudal
GVDAL	goodall
GVDARD	goddard
GVDATA	gudata
GVDAT	gudat
GVDAYNAF	goodenough
GVD	good
GVDGR	goodger
GVDHV	goodhew
GVDL	godel
GVDMAN	goodman
GVDMN	goodman
GVDNAF	goodenough
GVDRAM	goodrum
GVDRAN	gudrun
GVDRV	gaudreau
GVDRV	goudreau
GVDRYC	goodrich
GVDSN	goodsen
GVDSVN	godson
GVDVYN	godewyn
GVDVYN	goodwin
GVDYNG	golding
GVDYN	godewyn
GVDYR	goudier
GVDYVAYN	godewyn
GVDYVYN	godewyn
GVGAN	goegan
GVGR	goodger
GVGVAN	goguen
GVHD	gohde
GVH	goh
GVHYN	goheen
GVKYANV	guoqiano
GVLAND	goland
GVLAN	gollan
GVLDYNG	goulding
GVL	goel
GVLSBY	goolsbee
GVLT	gowlett
GVLVMB	golomb
GVLY	gully
GVMZ	gomes
GVMZ	gomez
GVNAR	gunnar
GVNNA	gonna
GVNTVRP	gunthorpe
GVNVT	gonot
GVNY	gony
GVNZALS	gonzales
GVNZALS	gonzalez
GVNZALV	gonzalo
GVNZALZ	gonzalez
GVPALA	gopala
GVPALAN	gopalan
GVPTA	gupta
GVPTH	gupte
GVPVL	gupwell
GVPYNAT	gopinath
GVRALAVALA	goralwalla
GVRAL	gural
GVRALP	guralp
GVRAN	goran
GVRAPARTAP	gurupartap
GVRASPY	gorospe
GVRAV	gorav
GVRBRG	gorberg
GVRDF	gurdev
GVRD	gorde
GVRD	goverd
GVRDN	gourdon
GVRDYN	gordin
GVRGAN	gorgon
GVRGANZ	gorgons
GVR	goor
GVR	gore
GVRKY	gorki
GVRL	gorel
GVRLY	gourlay
GVRM	gorm
GVRMT	gourmet
GVRNAL	gornall
GVRNY	gurney
GVRTVN	gorton
GVRV	guru
GVRVSAMY	gurusamy
GVRVYTZ	gorwitz
GVRY	gorry
GVRYK	gorik
GVRYNCM	gorinchem
GVRYNDR	gurinder
GVRYNG	goringe
GVRYNMN	gorinchem
GVRYS	goris
GVSF	gusev
GVS	goch
GVSTAV	gustav
GVSTAVS	gustavus
GVSTAVVS	gustavus
GVSTLV	gostelow
GVSVL	goswell
GVSVYL	goswell
GVSY	gooshy
GVTHARD	gotthard
GVTJS	gootjes
GVTLYB	gottlieb
GVTY	gootee
GVTYK	gothic
GVVDGR	goodger
GVVDYNG	gooding
GVVRD	goverd
GVVVSYS	gouvousis
GVVYNDR	govinder
GVYAT	guyatt
GVYDV	guido
GVY	gui
GVYKARYS	geocaris
GVYLAM	guillaume
GVYL	goel
GVYL	govil
GVYL	gowell
GVYLRMV	guillermo
GVYN	gwin
GVYN	gwynn
GVYVDA	gouda
GVYYDV	guido
GVYYJR	gooijer
GVYYLYM	gwillim
GVYYN	gwynn
GVZVYTZ	gosewitz
GYANASY	giannasi
GYAT	guyatt
GYBSN	gibson
GYBSVN	gibson
GYBVNY	gibboni
GYBVNZ	gibbons
GYBVR	gabor
GYDRY	guidry
GYDV	guido
GYDVN	gideon
GYDZ	gades
GYFT	gift
GY	gee
GYGR	geiger
GYJSBRTAS	gijsbertus
GYJSBRTVS	gijsbertus
GYLAGLY	gillogly
GYLAM	gillam
GYLAM	guillaume
GYLBAY	gilby
GYLBRT	gilbert
GYLFRD	guilford
GYLFVRD	guilford
GYL	gail
GYL	gale
GYL	gil
GYL	gill
GYLMN	gillam
GYLMN	gilman
GYLMR	gilmer
GYLN	gillen
GYLNR	gilner
GYLPYN	gilpin
GYLR	gayler
GYLRM	guillerm
GYLRMV	guillermo
GYLRVY	gilroy
GYLRY	guillory
GYLSPAY	gillespie
GYLSPY	gillespie
GYLT	gillett
GYLVT	gaillot
GYLYAM	gilliam
GYLY	gilley
GYLY	gillie
GYLYS	gillies
GYLYS	gillis
GYLYTA	geleta
GYLYZ	gillies
GYLYZ	gillis
GYML	gemmell
GYMNV	gimeno
GYMNZ	gimenez
GYN	gwynn
GYNKZ	genks
GYNSBRG	ginsburg
GYNTN	ginton
GYNTVN	ginton
GYPJH	gepje
GYPN	gapen
GYRARD	girard
GYR	gair
GYR	geier
GYRHART	gearhart
GYRTRVYD	geertruyd
GYRTSN	geertsen
GYRVLAYT	geervliet
GYRVLYT	geervliet
GYSBRTVS	gijsbertus
GYS	ghayth
GYSH	gische
GYSYLDA	gnishilda
GYTARD	guitard
GYT	gate
GYT	ghayth
GYTGY	geitgey
GYTLMN	gittelman
GYTLYN	gitlin
GYTN	gaetan
GYTNYK	gitnick
GYTS	gates
GYTVMR	gitomer
GYTVND	gaitonde
GYVF	geoff
GYVLYTY	giulietti
GYVN	givon
GYVVANY	giovanni
GYVVN	givon
GYVYN	gavin
GYVZ	guse
GYYANKVLA	giancola
GYZAV	gizaw
HABA	haba
HABRDR	habereder
HABR	haber
HABR	huber
HABRKAM	habercom
HABRLC	haberlach
HABRMN	haberman
HABRT	habert
HABS	hobbs
HABVRA	habura
HABVRG	hoborough
HABYN	hubein
HABZ	hobbs
HACHALTR	hochhalter
HACYNSVN	hutchinson
HACYNZ	hutchins
HACYSVN	hutchison
HADGZ	hodges
HADLND	hadland
HADLSTVN	huddleston
HADLY	hadley
HADRAMAT	hadramawt
HADRAMAVT	hadramawt
HADSN	hudson
HADSVN	hodson
HADSVN	hudson
HADVBA	hudoba
HADYA	hadiya
HADY	haddy
HADYL	hadil
HAFBK	hoffbeck
HAFMN	hoffman
HAFMN	hoffmann
HAFMN	huffman
HAFNYLYNG	houghtailing
HAFR	hafer
HAFSAH	hafsah
HAFS	hafs
HAGA	haga
HAGAN	hagan
HAGARD	haggard
HAGARD	hoggard
HAGDAL	hugdahl
HAG	hogg
HAGKYNZ	hodgkins
HAGLR	hagler
HAGLYN	hagelin
HAGMN	hageman
HAGMN	hodgeman
HAGN	hagen
HAGR	hager
HAGS	hughes
HAGSVN	hughson
HAGTN	houghten
HAGYN	hagin
HAHTAHA	huhtala
HAJ	haj
HAJKYNZ	hodgkins
HAJR	hajar
HAJRZ	hodgers
HAJS	hodges
HAJYR	hagir
HAJZ	hodges
HAKABAY	huckaby
HAKDT	hocdet
HAK	houck
HAK	huck
HAKLY	hackley
HAKNYS	hawkins
HAKSA	hackshaw
HAKSAV	hackshaw
HAKS	hawks
HAKSL	haxel
HAKSV	hackshaw
HAKVLYNN	hakulinen
HAKVYL	huckvale
HAKY	hockey
HAKYNG	hacking
HALAM	hallam
HALAN	hulan
HALAT	halat
HALDR	haldre
HALFLDR	holfelder
HALGR	haleger
HAL	hale
HAL	hall
HALKDYS	halkedis
HALK	halleck
HALKNR	holkner
HALM	halm
HALMN	holman
HALND	holland
HALN	hallen
HALPYN	halpin
HALR	haller
HALR	heller
HALRT	hallert
HALSTD	halsted
HALST	holst
HALTGRN	hultgren
HALTSYNGR	holtsinger
HALTVN	holton
HALTZ	holtz
HALVB	holub
HALYBRTVN	halliburton
HALYDY	holliday
HALYFYLD	hollifield
HALY	hale
HALY	haley
HALYMN	hollyman
HALYVL	halliwell
HALZR	holzer
HAMACY	hamachi
HAMAH	hamah
HAMANS	hammans
HAMANZ	hammans
HAMARKVYYST	hammarquist
HAMBYG	hambidge
HAMBYJ	hambidge
HAMD	hamad
HAMFRY	humphrey
HAMFRYZ	humpherys
HAMFRYZ	humphreys
HAMH	hamah
HAML	hamel
HAML	hammel
HAMMANZ	hammans
HAMNS	hammans
HAMPRYVN	hamparian
HAMPSAYR	hampshire
HAMPSYR	hampshire
HAMPTVN	hampton
HAMR	hammer
HAMSAYR	hampshire
HAMVND	hammond
HAMVNDZ	hammonds
HAMY	hami
HAMYL	hamill
HAMYLTN	hamilton
HAMYLTVN	hamilton
HANAFVRD	hannaford
HANA	hanaa
HANBVT	hanebuth
HANDL	handel
HANDRSVN	henderson
HANG	hung
HANGRFVRD	hungerford
HAN	han
HANKH	hanke
HANKLR	hunkler
HANKZ	hanks
HANSAKR	hunsaker
HANSN	hansen
HANSN	hanssen
HANSR	hansher
HANSVN	hanson
HANSVN	hansson
HANT	hunt
HANTYNGTVN	huntington
HANV	hannu
HANYA	haniyya
HANYFA	hanifa
HANY	hani
HANYH	haniyya
HANYMN	hannemann
HAPKARFT	hopcraft
HAPKRAFT	hopcraft
HAPKRFT	hopcraft
HAPKYNZ	hopkins
HAPR	hopper
HAPSVN	hopson
HARALD	harald
HARALDSN	haraldsen
HARARY	harari
HARATZ	haratz
HARBD	harbud
HARBR	harber
HARBR	harbor
HARBR	harbour
HARBRN	harburn
HARBRYJ	harbidge
HARBVD	harbud
HARBVR	harbor
HARBYG	harbidge
HARBYJ	harbidge
HARDN	harden
HARDYMN	hardiman
HARDYNG	harding
HARDYN	hardin
HARDYSVN	hardison
HARGRAVZ	hargroves
HAR	har
HARKL	hourcle
HARKR	harker
HARKVM	harkcom
HARKYN	harkin
HARKYNZ	harkins
HARLD	harald
HARLD	harold
HARL	harrell
HARLND	harland
HARLN	harlan
HARLV	harlow
HARMAN	harman
HARMANVS	harmanus
HARMN	harman
HARMNVS	harmanus
HARMVTV	haramoto
HARMZ	harms
HARNR	horner
HARP	harpe
HARPR	harper
HARPVLD	harpold
HARR	harrer
HARRYG	harrig
HARSA	harsha
HARS	hares
HARS	harsh
HARTAG	hartog
HARTAH	hurtah
HARTFYLD	hartfield
HART	hearth
HART	hurt
HARTL	hartel
HARTLP	hartlep
HARTLY	hartley
HARTMN	hartmann
HARTR	harter
HARTVL	hartwell
HARTVYL	hartwell
HARTYGAN	hartigan
HARVARD	harvard
HARV	harrow
HARVHYSA	haruhisa
HARVLD	harold
HARVL	harvell
HARVN	haroon
HARVN	haroun
HARVNY	haruni
HARVY	harvey
HARYCN	haricken
HARYHARAN	hariharan
HARYKN	haricken
HARYNKAR	harincar
HARYS	harish
HARYSVN	harrison
HARYV	horio
HARYZ	harries
HASAKAH	hasakah
HASAL	hassall
HASBRVK	hasbrouck
HASBY	husby
HAS	hass
HAS	hoss
HASKAL	hascall
HASK	husk
HASKL	haskel
HASKL	haskell
HASKYNZ	hoskins
HASLVM	haslum
HASMN	husemann
HAST	hassett
HASTTLR	hostetler
HASTVN	houston
HASTYNGZ	hastings
HASYK	husik
HATAP	hotopp
HATCSVN	hutcheson
HATCYNSVN	hutchinson
HATCYNZ	hutchins
HATCYSVN	hutchison
HAT	huth
HATLNDNSYS	holtlandensis
HATLY	huttley
HATM	hatem
HATMYKR	hatmaker
HATR	hutter
HATRL	hatrell
HATVN	hatton
HATVN	hutton
HATVRY	hattori
HAVARD	havard
HAVDVN	hawdon
HAVGTAYLYNG	houghtailing
HAV	hao
HAV	hau
HAV	haw
HAVK	hawk
HAVK	howk
HAVKR	hawker
HAVKYN	hawkin
HAVKYNZ	hawkins
HAVL	howell
HAVLY	hawley
HAVLZ	howells
HAVN	haven
HAVN	hawn
HAVS	house
HAVSR	houser
HAVTVN	houghton
HAVTYLYNG	houghtailing
HAVTYN	hawtin
HAVVLA	havola
HAVVNN	hyvonen
HAVY	hovey
HAVYS	howes
HAYBRD	hibberd
HAYBZ	hibbs
HAYC	haich
HAYDAR	haidar
HAYD	hyde
HAYDMN	heidmann
HAYDN	hayden
HAYGDAN	higdon
HAYKY	hickey
HAYLND	highland
HAYLT	hilletje
HAYLVRD	highlord
HAYLY	hailey
HAYM	hime
HAYNGH	hainge
HAYN	hain
HAYN	hine
HAYNLY	hinely
HAYNS	haynes
HAYNS	hines
HAYNY	haynie
HAYNZ	hinz
HAYNZ	hynes
HAYPLY	hippely
HAYR	huyer
HAYRVNYMVS	hieronimus
HAYSLVP	hyslop
HAYSVN	hyson
HAYTR	hayter
HAYTS	heights
HAYTZ	heights
HAYVARD	hayward
HAYVKYNSVN	hawkinson
HAYVKZ	hawkes
HAYVL	houle
HAYZ	hayes
HAYZ	hise
HAZN	hazen
HBNTVN	hebenton
HBRN	hebborn
HBRVQ	hoborough
HBVRN	hebborn
HBYBA	habiba
HBYBH	habiba
HDAD	haddad
HDAK	haddock
HDAVY	hadavi
HDAYA	hadaya
HDAYA	hudaydah
HDAYDAH	hudaydah
HD	head
HDLND	hadland
HDLND	headland
HDLVND	hedlund
HDLY	headley
HDRAMAVT	hadramawt
HDRAMVT	hadramawt
HDRMAT	hadramawt
HDRYK	hedrick
HDSA	hafsah
HDS	hafs
HDYA	hadiya
HDYDA	hudaydah
HDYDH	hudaydah
HDYH	hadiya
HDYL	hadil
HDYN	hedin
HFRVN	heffron
HFSA	hafsah
HFSAH	hafsah
HFS	hafs
HFSH	hafsah
HGARTY	hegarty
HGLND	hagland
HGTYLYNG	houghtailing
HGY	heggie
HGY	hegyi
HGYR	hagir
HHMN	hehman
HJR	hajar
HJRY	hajery
HK	hecke
HKR	hacker
HKR	hecker
HKSAV	hackshaw
HKSV	hackshaw
HKT	hackett
HKTVR	hector
HKYM	hakim
HKYNG	hecking
HKZN	hekezen
HLAB	halab
HLAL	helal
HLAN	heelan
HLAVYN	hlavin
HLB	halab
HLBLYNG	helbling
HLBYG	helbig
HLBYNG	helbing
HLD	heald
HLDN	holden
HLFMN	helfman
HLGA	helga
HL	hell
HLKANT	hellekant
HLK	helke
HLLR	heller
HLMN	helman
HLMN	holman
HLMNSTAYN	helmenstine
HLMR	hellmer
HLMZ	helms
HLMZ	holmes
HLNA	helena
HLND	holland
HLNDR	hollander
HLN	helen
HLN	hellen
HLR	heller
HLSTRVM	hellstrom
HLT	helt
HLTLANDNSYS	holtlandensis
HLTLNDNSYS	holtlandensis
HLTVN	healton
HLV	helou
HLVJ	hellwege
HLVM	holum
HLY	holle
HLY	holy
HLYNDN	hollinden
HLYVL	helliwell
HLZGNG	holzgang
HLZMN	holzman
HMAH	hamah
HMAM	hamam
HMANS	hammans
HMANZ	hammans
HMAR	dhamar
HMBAYJ	hambidge
HMBYJ	hambidge
HMDAN	hamdan
HMD	hamad
HMH	hamah
HML	hammel
HMP	hempe
HMPSAYR	hampshire
HMPSR	hampshire
HMRA	hamra
HMR	dhamar
HMR	hemer
HMR	hemmer
HMSTD	hemstede
HMSYRH	hampshire
HMYD	hamid
HMYLTN	hamilton
HMYLTVN	hamilton
HMZA	hamza
HMZ	hamza
HMZH	hamza
HNA	hanaa
HNA	hanan
HNAN	hanan
HNCLYF	hinchliffe
HND	hand
HNDL	handel
HNDRSN	henderson
HNDRSVN	henderson
HNDRYCVZ	hendricus
HNDRYCY	hendrickje
HNDRYKA	hendrica
HNDRYKAS	hendricus
HNDRYK	hendrickje
HNDRYKH	hendrickje
HNDRYKJ	hendrickje
HNDRYKJH	hendrickje
HNDRYKS	hendricks
HNDRYKS	hendricus
HNDRYKS	hendriks
HNDRYKSH	hendrikse
HNDRYKSN	hendrickson
HNDRYKSVN	hendrickson
HNDRYKVS	hendricus
HNDRYKY	hendrickje
HNDY	hendee
HNDZ	hands
HN	han
HN	hon
HNJ	hainge
HNJY	hentje
HNKL	henkel
HNKS	hanks
HNL	henle
HNLY	henley
HNNFNT	hennenfent
HNRYK	henrik
HNRYT	henriet
HNSLY	hensley
HNSN	hansen
HNT	hentje
HNTH	hentje
HNTJ	hentje
HNTJH	hentje
HNTYG	hentig
HNYA	haniyya
HNYFA	hanifa
HNYFH	hanifa
HNYGAN	hennigan
HNYG	honig
HNY	hani
HNY	hanney
HNYJ	hainge
HNYK	henneke
HNYNGSN	henningsen
HNY	rheni
HNZ	henze
HPKRAFT	hopcraft
HPLR	hepler
HQYR	hagir
HRABY	hrabi
HRAK	horak
HRAN	horan
HRANYKY	hranicky
HRAYZYNG	huizing
HRBAYJ	harbidge
HRBRT	herbert
HRBVRT	herborth
HRBYJ	harbidge
HRDASFYLD	herdsfield
HRD	heard
HRD	herd
HRDSFYLD	herdsfield
HRDZFYLD	herdsfield
HR	herr
HRLAYNDYZ	herlindis
HRLNDYS	herlindis
HRLVY	herlevi
HRLYNDYS	herlindis
HRMAN	herman
HRMAN	hermann
HRMAN	herrman
HRMAN	herrmann
HRMANS	hermans
HRMN	harman
HRMN	herman
HRMN	hermann
HRMN	herrmann
HRMNVS	harmanus
HRMNYVS	harmanus
HRMS	hermes
HRMVSV	hermoso
HRMZ	hermes
HRNAKY	hernacki
HRNANDZ	hernandez
HRNDVN	herndon
HRN	hearn
HRN	horn
HRN	horne
HRNKR	hornecker
HRNSBAY	hornsby
HRRA	herrera
HRSFAL	horsfall
HRT	hurt
HRTLYNG	hertling
HRTVK	hertweck
HRV	harv
HRVN	haroun
HRVNYMVS	hieronimus
HRVS	haroun
HRVY	hervey
HRYK	herrick
HRYKN	haricken
HRYNG	herring
HRYNGSAV	herringshaw
HRYS	harith
HRYSVN	harrison
HRYT	harith
HRYVL	hartwell
HSAKA	hasakah
HSAKAH	hasakah
HS	hasse
HS	hesse
HSH	hesse
HSKAH	hasakah
HSKH	hasakah
HSMANS	hesemans
HSMNS	hesemans
HSNA	hasna
HSN	hasan
HSN	hosn
HST	haste
HSTR	hester
HSTYNGZ	hastings
HSYMANZ	hesemans
HSYN	hosain
HSYN	husain
HSYN	hussain
HSYN	hussein
HTCR	hatcher
HTKVKS	hethcox
HTRYK	hetrick
HTZLR	hetzler
HVADLY	hoadley
HVA	hua
HVAR	hoar
HVBR	huber
HVBRMN	hoberman
HVBVRVG	hoborough
HVBVRV	hoborough
HVBVRVQ	hoborough
HVCYNSVN	hutchinson
HVDAYDAH	hudaydah
HVDGY	hodgin
HVD	houde
HVDKYNS	hodgkins
HVDKYNZ	hodgkins
HVDSN	hudson
HVDSVN	hodson
HVFGARD	hofgaard
HVFRD	hoford
HVFRYN	humphreys
HVFT	hooft
HVGAN	hogan
HVGARD	hoggard
HVGARD	huggard
HVGARTY	hogarty
HVG	hoge
HVG	hogg
HVG	hough
HVGLND	hoogland
HVGNBVM	hoogenboom
HVGN	huigen
HVGS	hughes
HVGTAYLYNG	houghtailing
HVGTYLYNG	houghtailing
HVGV	hugo
HVGVYN	hoogeveen
HVHNSVN	hohensohn
HV	hough
HV	howe
HVK	hook
HVKN	hawken
HVLAND	holland
HVLDN	holden
HVLDZVRS	holdsworth
HVL	holle
HVL	houle
HVLKAMB	holcomb
HVLKNR	holkner
HVLM	holm
HVLMN	holman
HVLMZ	holmes
HVLNDNSYS	holtlandensis
HVLRVYD	holroyd
HVLS	hulse
HVLSTN	holsten
HVLTLNDNSYS	holtlandensis
HVLYMN	hollyman
HVLZN	holzen
HVLZVARS	holzwarth
HVMAK	hummock
HVM	hume
HVM	humm
HVMN	homan
HVNG	hung
HVNYGBRG	honigberg
HVP	hope
HVP	hoppe
HVPR	hooper
HVQTYLYNG	houghtailing
HVQYM	hoogheem
HVRGAN	horgan
HVRKAN	horkan
HVRN	horn
HVRNR	horner
HVRSFVRD	horsford
HVRST	horst
HVRTMN	hortmann
HVRTR	howerter
HVRVAT	horvat
HVRVT	horvat
HVRVVYTZ	horowitz
HVRVYTZ	horowitz
HVRYGMV	horrigmo
HVRYHAN	hourihan
HVRY	horree
HVRYNG	hornig
HVRYV	horio
HVS	hoos
HVSMN	houseman
HVSTVN	houston
HVTN	hutton
HVVART	howarth
HVVN	hooven
HVVR	hoover
HVYA	hua
HVYBRG	hoiberg
HVYD	hviid
HVYGN	huigen
HVYJN	huigen
HVYMAN	hoyman
HVYNG	hewing
HVYSR	huyser
HVYT	hewitt
HVYTYNK	hoitink
HVYYSKN	huisken
HVZ	howes
HYBAX	haibach
HYBRG	heiberg
HYBRT	hibbert
HYBVRN	hebborn
HYCMN	hitchman
HYCNS	hitchens
HYDAJAT	hidajat
HYDLAND	headlund
HYDN	hayden
HYDN	heiden
HYDNR	heidner
HYDR	haidar
HYDRYC	heiderich
HYDRYS	heidrich
HYFA	haifa
HYFLR	heffler
HYFTZ	heifetz
HYGARTY	hegarty
HYGL	heigl
HYGN	hagen
HYGRMN	hegermann
HYGVNT	higonnet
'HYH	aahie
HY	hei
HYJDAN	higdon
HYJMN	hitchman
HYKARV	hikaru
HYK	haik
HYKMN	hickman
HYKSVN	hixon
HYKV	heiko
HYKY	heikki
HYKY	hickey
HYLBRY	hillberry
HYLDBRAND	hildebrand
HYLD	heald
HYL	hail
HYL	hale
HYL	heil
HYL	hill
HYL	hille
HYLKR	hilker
HYLMR	hilmer
HYLNBRND	hillenbrand
HYLND	heiland
HYLND	hyland
HYLNTH	hilletje
HYLRY	hillery
HYLS	hills
HYLSNTYGR	hilsenteger
HYLSVN	hilson
HYLT	heyltje
HYLTH	heyltje
HYLT	hilletje
HYLTJ	heyltje
HYLTJH	heyltje
HYLTJH	hilletje
HYLTJ	hilletje
HYLTN	hilton
HYLYARD	hillyard
HYLY	healey
HYLYRSTYN	hellerstein
HYLYS	hillis
HYLYTH	heyltje
HYLZ	hills
HYM	heim
HYMN	heymann
HYMN	hyman
HYMSTD	hemstede
HYNCLY	hinchley
HYNCY	hinchey
HYND	hind
HYNDRYKA	hendrica
HYNGAN	henegan
HYNG	hainge
HYN	hin
HYNJ	hainge
HYNLY	heinly
HYNR	hiner
HYNS	haynes
HYNS	hince
HYNS	hines
HYNSVN	hinson
HYNTVN	hinton
HYNTZ	heintz
HYNV	heino
HYNVNN	heinonen
HYNVZ	heinous
HYNZ	haynes
HYNZ	heinz
HYNZ	hines
HYNZ	hinz
HYNZ	hynes
HYPGRYV	hipgrave
HYP	hipp
HYPS	hipps
HYRAY	hirai
HYRDGN	heerdegen
HYRD	hird
HYRLY	hearley
HYRN	hearn
HYRNH	hearne
HYRN	hiern
HYRT	hirt
HYRVNYMAS	hieronimus
HYRVNYMVS	hieronimus
HYRVTA	hirota
HYSAN	hisan
HYS	heiss
HYSKVKS	hiscocks
HYSKVT	heathcote
HYSLAP	hyslop
HYSL	hisel
HYSLVP	hyslop
HYSMANS	hesemans
HYSMNS	heezemans
HYSR	heiser
HYTN	heetan
HYTR	heather
HYTR	heeter
HYTS	heights
HYTSVN	hitson
HYTVN	heaton
HYTZ	hiltz
HYTZ	hitz
HYVARD	hayward
HYVGN	huigen
HYV	hugh
HYVKYNZ	hawkins
HYVM	hume
HYVNGAN	hiongun
HYVNSV	hyunsoo
HYVVYT	hewitt
HYVZ	hughes
HYVZR	heuser
HYYN	hean
HYZ	hayes
HYZMAN	heezemans
HYZMANS	heezemans
HYZMNS	heezemans
HYZMNZ	heezemans
HYZYMNZ	heezemans
HZLTVN	hazelton
HZMNZ	hesemans
JABJH	jobje
JAB	jobje
JAB	jubb
JAD	jud
JAD	judd
JAD	jude
JAGARD	jagard
JAG	jog
JAGR	jager
JAGV	jago
JAHMANH	jahmane
JAHNS	johannes
JAKAMYNTH	jacomyntie
JAKSVN	jackson
JAKVAS	jacques
JAKVBH	jacobje
JAKVB	jacobje
JAKVBJH	jacobje
JAKVBJ	jacobje
JAKVBS	jacobs
JAKVBSVN	jacobson
JAKVBSVN	jacobsson
JAKVBY	jacoby
JAKVBZ	jacobs
JAKVMYNTAY	jacomyntie
JAKVMYNTYH	jacomyntie
JAKVMYNTY	jacomyntie
JAKVMYT	jacomyntie
JAKVS	jacques
JAKVYZ	jacques
JAKVZ	jacques
JAKYVZ	jacques
JALA	jala
JALVNN	jalonen
JAMVNA	jamuna
JANA	jana
JANARDHAN	janardhan
JANATVN	jonathon
JANCS	janches
JANG	jang
JANG	jong
JANG	jung
JANGNYKL	jungnickel
JANGR	junger
JANGTAYY	jongtae
JAN	jan
JAN	jann
JAN	john
JAN	jun
JANK	jahnke
JANK	junk
JANKYNSVN	jenkinson
JANSH	jansje
JANS	jansje
JANSJH	jansje
JANSJ	jansje
JANSKY	jansky
JANSN	janssen
JANSN	johansson
JANSVN	johansson
JANSVN	jonsson
JANTH	jaantje
JANT	jaantje
JANT	janotje
JANTJ	jaantje
JANTVJ	janotje
JANTYH	jaantje
JANVTH	janotje
JANVT	janotje
JANVTJH	janotje
JANY	johnny
JANYKA	janecka
JANZ	jansje
JANZ	johns
JAP	jaepje
JAPJH	jaepje
JAPJ	jaepje
JARAS	jarash
JARBVT	jarbot
JARDYN	jardine
JARS	jarash
JART	jarrett
JARVALA	jarwala
JARVYS	jarvis
JARYTJN	zjarritjen
JASCK	jaschek
JAS	josh
JASPR	jasper
JASPRZ	jaspers
JASTAM	justham
JASTAS	justus
JASTJH	justje
JASTJ	justje
JAST	jost
JASTJY	justje
JASTYH	justje
JASTYN	gustin
JASTYN	jostein
JASTYN	justin
JASTYN	justine
JASTYS	justice
JASVA	joshua
JASVYNDR	jasvinder
JATJY	tjaatje
JATYNDR	jatinder
JAVF	geoff
JAVYD	javed
JAVYKA	jovica
JAVYR	javier
JAYAN	jayan
JAYANT	jayant
JAYARAM	jayaram
JAYN	jain
JAYN	jayne
JAYNVR	gainor
JAYP	jaepje
JBHH	jaepje
JBH	jobje
JBYR	jabir
JDY	jedi
JF	geoff
JF	jeff
JFKK	jeffcock
JFRY	jeffrey
JFRYZ	jeffries
JHAMANH	jahamane
JHANG	jhang
JHAN	jehan
JHAR	jahra
JHMANH	jahmane
JHRA	jahra
JKBS	jacobs
JK	jack
JKMN	jackman
JKMN	jakeman
JKSVN	jackson
JKVBS	jacobs
JKVBSVN	jakobsson
JKVBZ	jacobs
JKYN	jokin
JLA	jala
JLAL	jalal
JL	gell
JLJ	jeltje
JLNY	jolene
JLTH	jeltje
JLT	jeltje
JLTJH	jeltje
JLVMARK	jelvemark
JMAL	gamal
JMAL	jamal
JMAR	dhamar
JML	gemmell
JML	jamal
JMML	gemmell
JMVLA	jamulla
JMYLA	djamila
JMYLAH	jamilah
JMYLA	jamilah
JMYL	gemmell
JMYLH	djamila
JMYLH	jamilah
JMYL	jamil
JNAH	jenah
JNA	jana
JNDRYAV	gendreau
JNDRYC	gendrich
JNG	jang
JNG	jeng
JN	jen
JNK	genks
JNK	jenneke
JNKS	genks
JNKS	jenks
JNKYNSVN	jenkinson
JNKZ	genks
JNT	jaantje
JNTJS	gentges
JNTRY	gentry
JNYFR	jennifer
JNYKH	jenneke
JNYK	jenneke
JNYNGZ	jenings
JNYRV	janairo
JNYSYLDA	gnishilda
JPSN	jeppesen
JPY	gepje
JRADA	jerada
JRALD	gerald
JRARD	gerard
JRARD	girard
JRARDY	gerardi
JRGNZ	jergens
JRHARD	gerhard
JRMYAS	jeremias
JRMY	jeremy
JRMYK	jeremic
JRMYS	jeremias
JRS	jarash
JRSTL	gerstl
JRTRVD	gertrude
JRVNYMVS	jeronimus
JRVNYVS	jeronimus
JRVYS	jarvis
JRYNG	gerringe
JRYNGR	grainger
JRYTSMA	jorritsma
JRYTY	gerrity
JRYTZVN	gerritzon
JSF	joseph
JSPR	jesper
JSTR	jester
JSTVN	geston
JSYKA	jessica
JSYK	jessick
JTRV	jethro
JTSAM	jetsam
JVAB	joab
JVANA	juana
JVANDR	juvander
JVANG	juang
JVAN	joan
JVAN	juan
JVANYTA	juanita
JVAV	joao
JVAY	juay
JVBAL	jubal
JVBJ	jobje
JVB	jobje
JVB	joubb
JVBYN	joubin
JVDAS	judas
JVD	judd
JVDY	judi
JVDY	judy
JVF	geoff
JVF	joffe
JVFL	geoffl
JVGLA	jougla
JVHANA	johanna
JVHAN	johann
JVHANSN	johannesen
JVHANSN	johansen
JVHANSVN	johannson
JVHANSVN	johansen
JVHANSVN	johansson
JVHANY	juhani
JVHANZ	johanes
JVHANZ	johannes
JVLAY	joly
JVL	jewell
JVL	joel
JVLTZ	joltes
JVLYANTH	juliaantje
JVLYANTJH	juliaantje
JVLYANTJ	juliaantje
JVLYANT	juliaantje
JVLYANY	giuliani
JVLYF	jolliff
JVLY	jolee
JVLY	jolly
JVLY	joly
JVNAS	jonas
JVNGAN	joungane
JVNGANZ	junghans
JVN	jonn
JVN	jun
JVN	june
JVNV	juno
JVNY	jouni
JVNYN	jonin
JVNYVR	junior
JVPRV	joppru
JVRAH	jurah
JVRA	joura
JVRAN	jurran
JVRAVLV	jouravlev
JVRGNZ	jurgens
JVRJ	jorge
JVRJN	joergen
JVRJN	jorgen
JVRJYA	georgia
JVRJYV	georgeu
JVRK	jurek
JVRVYTZ	goerwitz
JVRY	jory
JVRYNG	goering
JVRYSMA	jorritsma
JVRYTSMA	jorritsma
JVS	jooss
JVSLYN	joslin
JVSTH	justje
JVSTJ	justje
JVSTY	justje
JVSVA	joshua
JVSVYG	joswig
JVSYP	josip
JVTLYN	guethlein
JVVN	givon
JVYDYP	joydeep
JVYNR	joiner
JVYNR	joyner
JVYSF	joesph
JVYS	joyce
JVYT	jewett
JVYT	jowett
JVZA	juza
JVZF	joseph
JVZFVS	josephus
JVZP	joseph
JVZY	gozzi
JVZYH	josie
JVZY	josey
JVZY	josi
JYAF	geoff
JYA	jia
JYAKVB	giacobe
JYAN	jian
JYANY	gianni
JYAVRDANY	giordani
JYBSVN	gibson
JYBYNS	gibbins
JYGANG	jigang
JY	gee
JY	jee
JYJSBRTVS	gijsbertus
JYKMN	jakeman
JYLAM	gillam
JYLBRT	gilbert
JYL	gill
JYLT	gillett
JYLYAN	jillian
JYLZ	jilles
JYM	jim
JYML	gemmell
JYMSVN	jameson
JYMY	jamie
JYMYNY	jiminey
JYMZ	gems
JYMZ	james
JYMZ	jaymes
JYNAKYRAMAN	janakiraman
JYNG	jing
JYN	gwynn
JYN	jain
JYN	jayne
JYN	jean
JYN	jin
JYNS	janes
JYNTVN	ginton
JYNYK	janecek
JYNZ	janes
JYPH	jaepje
JYRARDYN	gerardin
JYRMASKA	germuska
JYRVSK	jirousek
JYSH	jesse
JYS	jess
JYSR	geiser
JYSTR	jester
JYSVZ	jesus
JYTA	jitta
JYVK	jiok
JYVRDANV	giordano
JYVVANY	giovanni
JYVVYL	jewell
JYVYL	jewell
JYZAN	jizan
JYZN	jizan
JYZSBRTVS	gijsbertus
JZYRH	jezire
KAB	kube
KABRYLV	cabrello
KACLYNG	kuchling
KACV	cacho
KACVN	cauchon
KACY	cutchie
KACYH	cutchie
KADLASK	kudlacek
KADMN	cadman
KADMVS	cadmus
KADN	kaden
KADRYBYSYK	kadribasic
KADRYKYS	kudreikis
KADV	kado
KADYN	kadin
KAFRY	caffrey
KAFY	coffee
KAFYN	coffin
KAGBVRN	cogburn
KAGL	cagle
KAGL	kagle
KAGLYN	coughlin
KAGSAL	coggeshall
KAGSVL	cogswell
KAHAN	kahane
KAHVN	cahoon
KAKALK	kacalek
KAKANDS	kacandes
KA	kao
KAKBRYD	cakebread
KAKDKAR	kakodkar
KAKRAFT	cockroft
KAKRYL	cockerill
KAKSHD	coxhead
KAKTVS	cactus
KAKY	kaki
KAKYVLA	cacciola
KAKYVR	kakure
KALA	cala
KALAFATAS	kalafatas
KALAFVT	kalafut
KALAHAN	calahan
KALANAN	callanan
KALATVR	kalathur
KALBAVT	callebaut
KALB	kalb
KALB	kaleb
KALBRYJ	calbridge
KALBYDA	kulbida
KAL	call
KALDL	kuldell
KALDVL	caldwell
KALDVL	cauldwell
KALDYS	kaldis
KALHYN	culhane
KALHYNH	culhane
KAL	kalle
KALKAN	kalkan
KALKLASVR	colclasure
KALMAN	kalman
KALMN	kuhlmann
KALMN	kullmann
KALMYS	kalemis
KALPAK	kalpak
KALPANA	kalpana
KALPS	kalpesh
KALPYN	culpin
KALR	koller
KALRTY	claertie
KALRY	kolluri
KALSGH	claesje
KALSVN	coulson
KALSYN	calsyn
KALT	collett
KALTVN	colton
KALV	calow
KALVM	collum
KALVNLV	colonello
KALVRT	calvert
KALVYN	calvin
KALYA	kalia
KALYAN	kalyan
KALYANY	kalliany
KALYARV	caliaro
KALY	collie
KALYGY	cauligi
KALYLA	kalila
KALYNSAN	calinisan
KALYNT	collinet
KALYNZ	collins
KALYS	callis
KALYS	kalish
KALYSYAK	kalisiak
KALYYVS	calius
KAMACV	camacho
KAMALA	kamala
KAMAL	kamal
KAMAMA	camama
KAMAR	kumar
KAMAT	kamath
KAMB	kamb
KAMBS	combs
KAMBYTZ	combites
KAMBYY	combee
KAMBZ	combs
KAMDAR	kamdar
KAMHVLZ	kamholz
KAM	kam
KAM	kame
KAML	kamel
KAMLN	kamelen
KAMLYS	kamlish
KAMN	kamen
KAMNS	kamens
KAMPAGNA	campagna
KAMPAR	kompar
KAMPBL	campbell
KAMP	kampe
KAMPR	kamper
KAMPTVN	compton
KAMPVS	campos
KAMPYLV	campillo
KAMPYVTR	computer
KAMR	kummer
KAMRVD	kamerud
KAMRVN	cameron
KAMRVS	cameros
KAMSKAYA	kamskaya
KAMSTAK	comstock
KAMYA	kamiya
KAMYNG	cumming
KAMYN	kamien
KAMYV	comeau
KANAKAKVRN	kanakakorn
KANA	kana
KANAK	kanak
KANAL	canale
KANAL	channel
KANAN	kannan
KANAVA	cannava
KANBVY	conboy
KAN	cone
KANDAYV	candau
KANDLY	condelli
KANDV	kundu
KANDVYYT	conduit
KANDY	kandi
KANFR	confer
KANFYLD	canfield
KANG	cong
KANG	kang
KANG	kong
KAN	kane
KANKNT	conconi
KANLN	conlon
KANLY	conley
KANLY	connelly
KANN	canon
KANR	connor
KANRLY	conerly
KANRVY	conroy
KANSL	counsell
KANSTABARYS	constabaris
KANSTABV	konestabo
KANTARA	cantara
KANTH	conte
KANT	kant
KANT	kunst
KANTRA	cantara
KANTR	kanter
KANTRL	cantrell
KANV	cano
KANVRY	convery
KANYA	kania
KANYF	cunniff
KANYG	konig
KANYNGHAM	cunningham
KANYS	canis
KANYSNA	katishna
KANYTZ	cunitz
KANYVN	canyon
KANZY	kanze
KAPA	kappa
KAPANGA	kapanga
KAP	kapp
KAPK	kupec
KAPLAN	kaplan
KAPLN	kaplan
KAPLYNK	kaplenk
KAPNR	kapner
KAPRAL	kapral
KAPS	copps
KAPSVN	kapson
KAPVR	kapoor
KAPYLA	kapila
KARABVLVT	karabulut
KARAGR	carragher
KARAHR	caraher
KARA	kara
KARANJLV	carangelo
KARAN	karan
KARARA	carrara
KARASA	karaca
KARAS	karras
KARASKV	carrasco
KARASV	karasu
KARAYL	karayel
KARBAJAL	carbajal
KARBALA	karbala
KARBN	carbone
KARBVNLY	carbonelli
KARBVNYA	carbonneau
KAR	carr
KARDAL	kardal
KARDL	kardal
KARDL	kardel
KARDLYS	kardelis
KARDNAS	cardenas
KARDYNALY	cardinali
KARGYL	cargill
KARHART	carhart
KARKARN	corcoran
KARKAS	karakash
KARLAYL	carlile
KARL	carl
KARL	karl
KARLKVYST	karlquist
KARLS	carlos
KARLSVN	karlsson
KARLTVN	carlton
KARLTVN	charlton
KARLVS	carlos
KARLVT	charlotte
KARLYN	carlin
KARLYN	charlyn
KARMAN	karmann
KARMVDY	carmody
KARMVNA	carmona
KARMYCAYL	carmichael
KARN	karen
KARN	karn
KARNLYAN	carnelian
KARNR	karner
KARNRY	carnerie
KARNYA	carina
KARNY	carney
KARNY	carnie
KARNZ	carnes
KARP	karp
KARPLAS	karplus
KARPNTR	carpenter
KARPNTYR	charpentier
KARSTNSN	carstensen
KARSTNZ	carstens
KARSVN	carson
KARSVN	karlsson
KART	kurt
KARTNR	curtner
KARTRAYT	cartwright
KARTR	carter
KARTVYZ	courtois
KARTY	karty
KARTYK	kartik
KARTYR	chartier
KARTYS	curtis
KARVLYN	carolyn
KARVR	carver
KARVSV	carosso
KARVSV	caruso
KARVYN	karwin
KARYAGA	cariaga
KARY	currie
KARY	curry
KARYDA	karida
KARYDYAN	karridian
KARYH	currie
KARYJR	kariger
KARY	kari
KARYLV	carrillo
KARYRA	carreira
KARYS	karish
KASAK	kusack
KASAMA	kasama
KASAM	kassam
KASANVVA	casanova
KASARA	cassara
KASAT	kasat
KASGRVH	cosgrove
KASL	cosell
KASLMN	casselman
KASM	kassem
KASMN	cushman
KASMYCY	kosmicki
KASNR	casner
KASNYR	kushnir
KASPRZAK	kasprzak
KASRTYNV	casertino
KASRYL	casriel
KASTA	costa
KASTANV	castano
KASTLV	costello
KASTLV	gostelow
KASTNR	costner
KASTNR	kastner
KASTRCM	kasterchem
KASTRGYN	castergine
KASTR	koster
KASTRV	castro
KASTRYKAM	castricum
KASTRYKVM	castricum
KASTRYVM	castricum
KASTVL	goswell
KASTVRY	kasturi
KASTY	casti
KASTYLV	castillo
KASTYN	kastein
KASVF	kasouf
KASVN	kasun
KASY	koci
KASYNG	cushing
KASYNLY	cassinelli
KASYNSKY	kosinski
KASYV	cascio
KATA	katta
KATALANV	catalano
KATAN	kattan
KATARYN	catharyn
KATB	kateb
KATBRT	cuthbert
KATCY	cutchie
KATKART	cathcart
KATL	cottle
KATL	kathol
KATLMN	katleman
KATLR	cutler
KATLYR	cutler
KATN	katen
KATR	cutter
KATRNTJ	katryntje
KATRYJ	catrijn
KATRYJN	catrijn
KATRY	kateri
KATRYNA	caterina
KATRYNA	katrina
KATRYN	catharyn
KATRYN	catherine
KATRYN	catrijn
KATRYN	katrin
KATRYN	katryntje
KATRYNTH	katryntje
KATRYNTJH	katryntje
KATRYNTJ	katryntje
KATRYNTY	katryntje
KATVALA	katwala
KATVPYS	katopis
KATY	kati
KATYNG	cutting
KATZ	katz
KAVASYN	cavasin
KAVAYY	kawai
KAV	cao
KAV	cau
KAVDLYNG	quodling
KAVDYL	caudill
KAVH	kave
KAVH	kaveh
KAV	kao
KAVLY	cowley
KAVLY	mccauley
KAVLYNG	cowling
KAVN	koven
KAVRZ	cavers
KAVS	kaos
KAVSTN	cawston
KAVYTA	kavita
KAYA	kaya
KAYAK	kayak
KAY	kai
KAYK	kauk
KAYLAS	kailas
KAYL	kyle
KAYN	cain
KAYN	kain
KAYNY	caine
KAYPR	kuyper
KAYRAS	kyrus
KAYRD	caird
KAYRVF	kairoff
KAYSR	kayser
KAYT	kight
KAYT	kyte
KAZDAN	kazdan
KAZGRYF	cosgriff
KAZMAYR	kazmaier
KAZVHYRV	kazuhiro
KAZVNVZY	kazunori
KAZY	kazi
KAZYR	cazier
KAZYRR	kassirer
KBAKYAN	kabakian
KBAKYBV	kabakibo
KBANYS	cabaniss
KBRG	koberg
KBR	keber
KBYR	kabir
KBYR	kebir
KCNG	kecheng
KDAVR	cadaver
KD	code
KDL	cadle
KDL	cedelle
KDR	kedar
KDYM	kadin
KDYN	kadin
KDYRA	qadira
KDYR	qadir
KDYSYA	qadisiyah
KDYSYH	qadisiyah
KFART	kephart
KHV	kehoe
KK	keck
KLABVRN	clabourne
KLAF	clough
KLAG	kellogg
KLAG	klug
KLAGSTVN	clugston
KLAK	clack
KLAMN	clamen
KLAMR	klammer
KLANFYLD	clanfield
KLANSY	clancey
KLANTVN	clanton
KLARJH	klaartje
KLARK	clark
KLARK	clarke
KLAR	kellar
KLARTAY	claertie
KLARTH	klaartje
KLARTJH	klaartje
KLARTJ	klaartje
KLARTJY	klaartje
KLART	klaartje
KLARTY	claertie
KLARYJ	claridge
KLASA	klassa
KLASJ	claesje
KLASJH	claesje
KLASMYR	klausmeier
KLASN	klassen
KLASNR	klossner
KLAT	klatt
KLATZ	klotz
KLAVDYA	claudia
KLAVDY	claude
KLAVSY	clawsie
KLAVYTR	klawiter
KLAYN	klein
KLAYN	kline
KLAYR	claire
KLAYSJ	claesje
KLAYSVN	claeson
KLAYSVN	clayson
KLAYTVN	clayton
KLAZ	claesje
KLAZVRA	klazura
KLAZYNG	clausing
KLBAY	kilby
KLB	kalb
KLBRN	colburn
KLBVRN	claborn
KLBVRN	colburn
KLBY	colbey
KL	col
KLDNY	kolodney
KLDVL	caldwell
KLDVY	coldewey
KLFLT	colfelt
KLKAR	kelkar
KL	kehle
KL	kole
KLMANZ	klemans
KLMBV	colombo
KLMN	kellman
KLMP	klemp
KLNFYLD	clanfield
KLN	kellen
KLN	keulen
KLNR	kellner
KLRTAY	claertie
KLRTY	claertie
KLRVS	claros
KLT	collette
KLTN	colten
KLTNR	keltner
KLVB	club
KLVBK	kloubek
KLVKYNAS	kloukinas
KLVLY	clewley
KLVMPNR	clumpner
KLVNFRV	clonfero
KLVSN	claussen
KLVTH	klute
KLVYNN	kelvinen
KLYBR	klyber
KLYBRN	cliburn
KLY	clay
KLY	coley
KLYF	cliff
KLYFRD	clifford
KLYFT	clift
KLYFTVN	clifton
KLYK	cleek
KLY	kelly
KLY	klee
KLYLA	kalila
KLYMR	klemmer
KLYMVF	kelimoff
KLYNGRVT	chillingworth
KLYNK	klinck
KLYN	klein
KLYN	kline
KLYNSVRG	kleinsorge
KLYNZ	collins
KLYR	claire
KLYR	clare
KLYR	cleere
KLYR	kleier
KLYRTYH	claertie
KLYS	claesje
KLYSH	claesje
KLYTVN	clayton
KLYVY	cleavey
KMA	koma
KMAL	cemal
KMAL	gamal
KMBRY	kimberey
KMBS	combs
KMBZ	combs
KMDR	kamdar
KMFVYS	kamphuis
KMFYLD	camfield
KM	kam
KMKR	kemker
KMLLV	chemello
KMPASTR	kempster
KMPBL	campbell
KMP	kemp
KMP	kempe
KMPR	kemper
KMPSTR	kempster
KMPVS	campos
KMPY	campey
KMR	comer
KMR	kumar
KMR	qamar
KMRVN	cameron
KMSPTR	kempster
KMSTR	kempster
KMYLAH	kamilah
KMYLA	kamilah
KMYLH	kamilah
KMYR	kammeyer
KNAMVRY	kanamori
KNAVAY	kennaway
KNDAL	kendall
KNDL	kandell
KNDRYK	kendrick
KNDV	kundu
KNDVLF	kandolf
KNDY	candy
KNDYG	kendig
KNDY	kendi
KNG	keng
KNG	kong
KN	kean
KN	ken
KN	kenn
KNNYNG	kenning
KNPVL	kennepohl
KNRAD	coenraad
KNRAD	coenraedt
KNRAD	koenraad
KNRADVS	coenradus
KNRAT	coenraadt
KNRDYNG	konerding
KNR	kenner
KNSYNGTV	kensingto
KNTA	kenta
KNTARV	kentaro
KNVB	knob
KNVFYNKH	knufinke
KNVL	knoll
KNY	kenney
KNY	keny
KNYKRBKR	knickerbacker
KNYNGTVN	kennington
KNYN	kenyon
KNYSKY	kensiski
KNYVN	canyon
KNYVN	kenyon
KNZ	kenz
KPJH	kapje
KPL	keppel
KPLY	kepley
KPR	knepper
KPRT	caprette
KPTAN	kapetan
KPYSTRAN	capistran
KRAB	krab
KRA	cera
KRACLY	crouchley
KRACLY	crutchley
KRACN	kruschen
KRACR	crutcher
KRAKART	crockart
KRAKFRD	crockford
KRAKFVRD	crockford
KRAK	kraack
KRAK	kruk
KRAKT	crockett
KRAMARY	karumuri
KRAMHVRN	crumhorn
KRAMR	cramer
KRANDLMYR	crandlemire
KRANSVYK	cranswick
KRANSVYYK	cranswick
KRANZVYK	cranswick
KRAP	krupp
KRAPR	cropper
KRAQTVN	croughton
KRARAS	karas
KRASBY	crosby
KRAS	cross
KRASN	crossen
KRASYK	krasic
KRATR	crater
KRATRZ	craters
KRATYGR	krattiger
KRATZR	kratzer
KRAVFVRD	crawford
KRAVL	crowell
KRAVLY	crawley
KRAVN	craven
KRAVN	crown
KRAVSVN	crowson
KRAY	cray
KRAYDR	crider
KRAYG	craig
KRAYG	kraig
KRAYJ	craig
KRAYJ	kraaij
KRAY	kerrie
KRAYSVL	criswell
KRAZN	krasen
KRAZYR	crozier
KRBLA	karbala
KRBL	kerbel
KRBSR	krebser
KRBTRY	crabtree
KRBVNYL	carbonell
KRBYT	corbit
KRC	krech
KRDAL	kardal
KRDLA	kardal
KRDL	kardal
KRDRY	cordrey
KRFT	craft
KRFTVN	crafton
KRG	craig
KRG	kregg
KRGR	kerger
KRGR	kurger
KRHANG	kerhong
KRH	kre
KR	karr
KRK	kurke
KRKRAFT	cracraft
KRKRAFT	crowcroft
KRLY	corley
KRLYVS	krelius
KRMR	cramer
KRMYK	cormick
KRMYT	kermit
KRNAY	kernie
KRNFRD	cranford
KRN	keren
KRN	kern
KRN	krenn
KRNL	carnell
KRNLYS	cornellis
KRNLYVS	cornelius
KRNS	carnes
KRNSVYK	cranswick
KRNVL	cornwell
KRNYZ	cernese
KRNZ	krenz
KRPS	crapse
KRRAY	kerrie
KRS	cress
KRS	kresh
KRS	kress
KRSKYNTYH	chrescyntie
KRSLYK	kerslake
KRSN	curson
KRSNR	kershner
KRSNR	krasner
KRSNV	krasnow
KRSPV	crespo
KRST	crest
KRSTN	kresten
KRSTS	crests
KRT	kert
KRTLND	courtlandt
KRTR	crater
KRTYN	curtain
KRTZR	kretzer
KRVASH	crevasse
KRVASZ	crevasses
KRVB	krob
KRVCFVRD	crockford
KRV	crowe
KRVD	kerwood
KRVG	krug
KRVKFVRD	crockford
KRVK	krok
KRVKN	kruschen
KRVL	carol
KRVM	crom
KRVM	croume
KRVMH	croume
KRVM	kroum
KRVM	krumm
KRVMN	kromann
KRVMR	kromer
KRVMY	croume
KRVMYTS	keromitis
KRVNHYM	cronheim
KRVNY	cerveny
KRVNZ	chrons
KRVPYK	kropik
KRVSBY	crosby
KRVSCN	kruschen
KRVS	crouse
KRVSH	crouse
KRVSN	crossen
KRVSN	kruschen
KRVTYV	croteau
KRVVD	kerwood
KRVYL	croyle
KRVYN	corwin
KRVYR	kreuer
KRVZ	crews
KRVZYR	crozier
KRY	cary
KRYCFYLD	critchfield
KRY	cray
KRYDA	karida
KRYDR	creider
KRYGAN	kerrigan
KRYG	craig
KRYG	krieg
KRYGR	krieger
KRYGR	kriger
KRY	kari
KRYK	creek
KRY	kerry
KRY	krey
KRYLA	kerila
KRYLAS	krelius
KRYL	kirill
KRYLYZ	crealese
KRYM	karim
KRYMN	kriman
KRYN	crain
KRYN	kerien
KRYN	kirin
KRYNZ	kerins
KRYPYV	crepeau
KRYQR	carragher
KRYR	carrier
KRYSAN	krishan
KRYSAYNTAY	chrescyntie
KRYS	chris
KRYSC	krisje
KRYS	crase
KRYS	creath
KRYSH	krisje
KRYSJH	krisje
KRYS	kris
KRYS	krisje
KRYSP	crisp
KRYSPN	crispen
KRYSPYJN	crispijn
KRYSPYN	crispijn
KRYSSAYNTYH	chrescyntie
KRYSTA	christa
KRYSTA	krista
KRYSTAL	christal
KRYSTAL	christall
KRYSTAL	crystal
KRYST	crest
KRYSTLR	kristler
KRYSTMN	christman
KRYSTMN	christmann
KRYSTN	christen
KRYSTR	krister
KRYSTV	christou
KRYSTVF	christophe
KRYSTVFR	kristopher
KRYSTVFRSVN	christopherson
KRYSTVN	crichton
KRYSTVN	kriston
KRYSTYANA	christiana
KRYSTYAN	christian
KRYSTYAN	kristian
KRYSTYANSN	christiansen
KRYSTY	christie
KRYSTY	christy
KRYSTYJNTH	kristijntje
KRYSTYJNTJH	kristijntje
KRYSTYJNTJ	kristijntje
KRYSTYNA	kristina
KRYSTYN	christine
KRYSTYNH	kristijntje
KRYSTYN	kristian
KRYSTYN	kristin
KRYSTYN	kristine
KRYSTYNTY	kristijntje
KRYSVAYJN	krisoijn
KRYSVJYN	krisoijn
KRYSVYJN	krisoijn
KRYSVYN	krisoijn
KRYSVZN	krisoijn
KRYSY	creasey
KRYSY	creasy
KRYSY	krissy
KRYSZ	krisje
KRYTR	crater
KRYVAS	crevasse
KRYVASZ	crevasses
KRYVN	craven
KRYVSN	kruschen
KRYVVNVZ	kriwonos
KRYYK	creek
KRZNA	kresna
KSAVAN	keshavan
KSAV	keshav
KSAY	kasai
KS	cash
KSK	kesek
KSKYN	keskin
KSL	cassel
KSL	castle
KSLN	keshlan
KSLR	kessler
KST	kast
KSTLAK	kostelak
KSTL	castle
KSTLVT	castellot
KSTNR	castner
KSTRAP	kastrup
KSTR	caster
KSTRCM	kasterchem
KSTRSVN	kesterson
KSVAN	kesavan
KSVN	kesson
KSYDY	cassidy
KSYM	qasim
KSYM	quasim
KTAN	ketan
KTARA	kotara
KTB	kateb
KTCAM	ketcham
KT	cat
KT	ket
KTLAR	cotlar
KTL	cattell
KTL	kettell
KTLT	catlett
KTLY	ketley
KTNZRV	catanzaro
KTSYMATYDS	catsimatides
KTVLA	ketola
KTVYN	chetwin
KTY	kathy
KTY	kotte
KTYL	ketil
KTZ	katz
KVAAYNTN	quainton
KVAKNBAS	quackenboss
KVAKNBVS	quackenboss
KVA	kwa
KVAL	kowal
KVALSYK	kovalcik
KVANBAY	quinby
KVANG	kheong
KVANG	kwang
KVANG	kwong
KVAN	kwan
KVANLAN	quinlan
KVANRAD	coenraad
KVANRAD	koenraad
KVANRADT	coenraadt
KVANRADVS	coenradus
KVANRDT	coenraadt
KVANRYD	coenraedt
KVANTVN	quainton
KVARSKY	kovarski
KVARTZYTH	quartzite
KVASMAN	coesmans
KVAST	kwast
KVASYM	quasim
KVATRYN	quatrain
KVAVRYNG	coevering
KVAYLYSY	quilici
KVAYMAN	coeyman
KVAYNTANA	quintana
KVAYNTVN	quainton
KVAYT	kuwayt
KVBA	kouba
KVB	kobb
KVB	kube
KVBLA	kubla
KVBN	kobben
KVBSA	kobsa
KVBV	cobo
KVBV	kubo
KVBYB	cobabe
KVBYLAH	qubilah
KVBYLA	qubilah
KVCAR	kuchar
KVC	couch
KVCRAN	cochran
KVCY	cutchie
KVCYH	cutchie
KVDAMAH	qudamah
KVDAMA	qudamah
KVDVGNV	codogno
KVDY	cody
KVGANDA	konganda
KVGLAN	coghlan
KVGLYN	coughlin
KVGVMA	kogoma
KVHAN	cohan
KVHN	cohn
KVJH	koosje
KVJYAS	kogias
KVKAL	kokal
KVKALYK	koukalik
KV	kao
KVKBRN	cockburn
KVK	cook
KVKFYLD	cockfield
KVK	kook
KVKNBAS	quackenboss
KVKNJ	kokenge
KV	kou
KVK	quoc
KVKRYL	cockerill
KVKSVN	cookson
KVKTAVAY	koktavy
KVKVNN	kokkonen
KVKVRK	kocourek
KVKYA	coccia
KVLASA	kolasa
KVL	col
KVL	cool
KVLKA	kolkka
KVLMN	colman
KVLN	colon
KVLN	kolen
KVLN	koolen
KVLNV	coleno
KVLR	koller
KVLSAR	kolesar
KVLS	kulesh
KVLSVN	coulson
KVLT	kolte
KVLTY	colety
KVLVL	colwell
KVLYCALA	kolichala
KVLY	cooley
KVLY	cully
KVLYHA	koliha
KVLYN	colin
KVLYNG	cowling
KVLYNGVVD	collingwood
KVLYNS	collins
KVLYNZ	collins
KVLYR	collier
KVLYS	koolish
KVMAR	kumar
KVMARV	comarow
KVMBR	coomber
KVMPTVN	compton
KVMR	comer
KVMR	kummer
KVMVRV	kumoro
KVMVRYTA	komorita
KVN	cone
KVNG	keong
KVNG	kong
KVNKA	cuenca
KVN	keven
KVN	kon
KVNRAD	coenraad
KVNRAD	koenraad
KVNRADVS	coenradus
KVNRAT	coenraadt
KVNRAT	coenraedt
KVNRAYT	coenraedt
KVNRYAT	coenraedt
KVNT	connett
KVNV	kono
KVNVPKA	konopka
KVNVR	connor
KVNVVR	conover
KVNYNG	koning
KVPJANZ	coppejans
KVPJ	coppedge
KVP	kopp
KVPLN	coplen
KVPLND	copeland
KVPLS	cupples
KVPNZ	coppeans
KVPR	koper
KVPR	kuper
KVPS	koppes
KVRADYNY	corradini
KVRAM	coram
KVRAN	curran
KVRAN	kevran
KVRAPATY	koorapaty
KVRBT	corbett
KVRBYN	corbin
KVR	corre
KVRDAS	kordas
KVRDS	kordes
KVRDYK	kordic
KVRDZ	cordes
KVRKAM	corkum
KVRKVL	courcoul
KVRL	corl
KVRLY	corley
KVRN	coren
KVRNLH	kornele
KVRNLVS	cornelius
KVRNLYS	cornellis
KVRNLYVS	cornelius
KVRNLYVSN	corneliusen
KVRNLYZ	cornellis
KVRNVAL	cornwall
KVRNYVL	cornuelle
KVRNZ	corns
KVRP	korp
KVRSL	courcelle
KVRSLV	corsello
KVRSN	kursun
KVRSTN	korsten
KVRT	cort
KVRTH	korte
KVRTL	cortell
KVRTLND	courtlandt
KVRTLNT	courtlandt
KVRTRAYT	kortright
KVRTZ	cortez
KVRVNLA	coronella
KVRVYN	corwin
KVRYA	correia
KVRY	corey
KVRY	coury
KVRYDVR	corridor
KVRYGAN	corrigan
KVRY	korey
KVRY	kory
KVRYLA	kurilla
KVRYL	coryell
KVRZAYN	corzine
KVSADA	quesada
KVSAK	kossack
KVSAY	kushay
KVSH	koosje
KVSJH	koosje
KVSJ	koosje
KVSKY	kousky
KVSKYMAKY	koskimaki
KVSLV	koslov
KVSMANS	coesmans
KVSMANZ	coesmans
KVSMAS	cosmas
KVSMNS	coesmans
KVSNKV	kosenko
KVSTA	costa
KVSTA	kosta
KVSTANZA	costanza
KVST	coast
KVSTN	kosten
KVSTRMN	kusterman
KVSTYLV	costello
KVSTYS	kostis
KVSVGH	kosuge
KVSYN	kocian
KVSYRA	kucera
KVSZ	koosje
KVTA	cotta
KVTCAY	cutchie
KVT	cote
KVTCY	cutchie
KVTJANZ	cootjans
KVTLA	kotla
KVTMAYR	kottmeier
KVTNY	coatney
KVTRVNYV	cotroneo
KVTY	cutie
KVTZ	kutz
KVVAR	kovar
KVV	cowe
KVVS	coves
KVYALSKY	kowalski
KVYALYK	kowalik
KVY	coy
KVYCY	koichi
KVYK	koike
KVYKNBAS	quackenboss
KVYKNBVS	quackenboss
KVYL	coil
KVYL	coyle
KVYL	quel
KVYLYN	quillin
KVYMN	coeyman
KVYN	cowen
KVYN	coyne
KVYN	kevin
KVYN	kevyn
KVYN	kuin
KVYN	quin
KVYN	quinn
KVYNRAD	coenraad
KVYNRAD	coenraadt
KVYNRAD	koenraad
KVYNRAT	coenraadt
KVYNRAYT	coenraedt
KVYNRDVS	coenradus
KVYNRYDVS	coenradus
KVYNRYT	coenraedt
KVYNTANA	quintana
KVYNTN	quainton
KVYNT	quint
KVYNTVN	quainton
KVYPR	kuiper
KVYRYN	querin
KVYSMAN	coisman
KVYST	quist
KVYT	kowitt
KVYT	kuwayt
KVYYKL	quickle
KVYYLYN	quillin
KVYYMAN	coeyman
KVYYMN	coeyman
KVYYNLN	quinlan
KVYYNTANAR	quintanar
KVYYNTVN	quainton
KVYY	que
KVYYST	quist
KVYYT	quitt
KVYYTZ	kewitz
KVYZMN	coesmans
KVZN	quezon
KVZV	kozo
KVZY	cozzi
KVZY	koosje
KVZYN	couzin
KYALASA	kailasa
KYASVN	chiasson
KYAT	kiat
KYB	cabe
KYBH	kibbe
KYBL	cable
KYBL	keeble
KYBLR	keebler
KYBLR	kibler
KYBV	kibo
KYCN	kitchen
KYCRV	cichero
KYCYN	kitchin
KYD	kid
KYD	kidd
KYDL	kiddle
KYDRA	keidra
KYF	keefe
KYF	kief
KYFR	keifer
KYFR	kieffer
KYGAN	keegan
KYGYNZ	kiggins
KYHL	kiehl
KYHV	kehoe
KYJV	keijo
KYKBRD	cakebread
KYKBRYD	cakebread
KY	keay
KY	kee
KY	kei
KY	key
KYK	kick
KYKVMA	kikuma
KYLAN	keelan
KYLBAY	kilby
KYLBRV	killebrew
KYLBY	kilby
KYLBYN	kilbane
KYLG	kilg
KYLGVR	kilgore
KYLH	kille
KYLHVRN	kielhorn
KYL	kale
KYL	keele
KYL	keil
KYLPK	killpack
KYLR	keeler
KYLR	keller
KYLR	killer
KYLRMT	killermet
KYLT	caillet
KYLY	kiely
KYLYVN	killion
KYLZ	kills
KYMBAL	kimball
KYMBRLY	kimberly
KYMBRY	kimberey
KYM	keim
KYM	kim
KYMPA	kimppa
KYMV	kimmo
KYMVN	kimon
KYMVRA	kimura
KYMZ	kimes
KYNA	kina
KYNAN	kinane
KYNANN	keinanen
KYNARD	kinard
KYN	cain
KYNCN	kinchen
KYNGASTVN	kingston
KYNGFAY	kingfai
KYNGRY	kingery
KYNGSFVRD	kingsford
KYNGSTVN	kingston
KYNGZTN	kingston
KYNH	kiehne
KYN	kain
KYN	kane
KYN	kean
KYN	keane
KYN	keen
KYN	keyne
KYN	kien
KYN	kin
KYNKNN	keinknen
KYNKYD	kinkade
KYNMN	kinman
KYNMN	kinsman
KYNRSLY	kinnersley
KYNSLA	kinsella
KYNSL	kinsell
KYNSMN	kinsman
KYNSVN	kinson
KYNT	kint
KYNT	knight
KYNTL	kintel
KYNY	kinky
KYNY	kinney
KYNYNY	keanini
KYNYVN	kinyon
KYNZ	kinns
KYNZMAN	kinsman
KYNZY	kinsey
KYP	cape
KYP	keep
KYP	kipp
KYPLYNG	kipling
KYPYNG	keeping
KYRA	kiera
KYRAN	kieran
KYRAS	kieras
KYRBAY	kirby
KYRBY	kirby
KYR	keir
KYRK	kirk
KYRTA	keerthi
KYRTY	keerthi
KYRVN	keiron
KYRYL	cyril
KYRYSY	kirishi
KYSA	keasha
KYS	case
KYS	kees
KYS	kish
KYS	kiss
KYSLV	kislo
KYSNRVS	cisneros
KYSR	keyser
KYSR	kiser
KYSTVFR	chistopher
KYSVN	cason
KYSY	casey
KYSYDY	cassidy
KYSY	keesee
KYSYNJR	kissinger
KYSYN	kissane
KYTAGVCY	kitaguchi
KYTAMVRA	kitamura
KYTC	kitch
KYTCN	kitchen
KYT	keat
KYT	keath
KYT	keet
KYT	kieth
KYT	kitt
KYTL	kittel
KYTLY	keithley
KYTS	kates
KYTY	katie
KYTYNG	keating
KYV	cave
KYVCY	kiuchi
KYV	kao
KYVK	quock
KYVKYVLYS	kukulies
KYVMR	kumar
KYVNG	cuong
KYVNG	keong
KYVNG	kiong
KYVS	chaos
KYVSMATV	kusumoto
KYVYVALY	kivivalli
KYVZVN	quezon
KYZR	kizer
KZMNZ	coesmans
'LAALDYN	alaaldin
LABAT	labatt
LABDN	labdon
LABDVN	labdon
LABKYN	lubkin
LABLA	labella
LABL	labelle
LAB	lobb
LABRAD	labroad
LABRYVLA	labriola
LABSR	lobser
LABYN	lubin
LACLN	lachlan
LACNS	lachance
LACYNY	luchini
LADASKY	ladasky
LADR	lodder
LADRVT	laderoute
LADVN	ladonne
LADVVYKA	ludovica
LADVVYKVS	ludovicus
LADVYG	ladwig
LADYK	ladic
'LADYN	alaaldin
LADYVYL	ladeuil
LAFAM	lapham
LAFAVNTYN	lafountaine
LAFGRYN	lofgren
LAFVRKAD	lafourcade
LAFY	laffey
LAGRLYNG	lagerling
LAGRSTRVM	lagerstrom
LAGVMVRVF	lagomorph
LAGVN	lagoon
LAHLMA	lahelma
LAHYJ	lahij
LAJ	lodge
LAJRBRG	lagerberg
LAKAY	laky
LAKH	locke
LAKLH	lacelle
LAK	loc
LAK	lock
LAK	locke
LAK	luce
LAKR	locker
LAKS	lax
LAKSV	laakso
LAKSYN	lockshin
'LAKVABAH	alaqabah
LAKVTVRH	lacouture
LAKVVD	lakewood
LAKY	lackey
LAKY	lucy
LAKYSA	lakesha
LALKYN	lulkin
LAL	lal
LALS	lawless
LALY	laly
LALYT	lalit
LAMARK	lamark
LAMASTVS	lamastus
LAMBARD	lombard
LAMBARDV	lombardo
LAMBDA	lambda
LAMBLY	lumbley
LAMBRN	lamborn
LAMBRT	lambert
LAMBRVS	lambros
LAMBVLY	lamboley
LAMBVRN	lamborn
LAMBVRN	lambourne
LAM	lam
LAM	lamm
LAMPLAYT	lamplight
LAMPN	lampen
LAMPY	lampi
LAMPYT	lampitt
LAMRS	lammers
LAMVRS	lamorce
LAMYKYN	lamykin
LANA	lana
LANDAGR	lundager
LANDASTRVM	lundstrom
LANDAYR	landauer
LANDBRG	lundberg
LANDGRN	lundgren
LANDGRYN	lundgren
LANDKVYYST	lundquist
LAND	land
LANDL	lundell
LAND	lund
LANDMN	landman
LANDN	landon
LANDR	londre
LANDRS	landers
LANDRVM	landrum
LANDRY	landry
LANDRZ	landers
LANDYN	landin
LANDYN	lundeen
LANDYS	landis
LANGDVN	langdon
LANG	lange
LANG	long
LANG	lung
LANGLY	langley
LANGNZ	langnes
LANGSA	longshaw
LANGSAV	longshaw
LANGSTVN	langston
LANGSV	longshaw
LANGV	lungu
LANGYR	longyear
LANJ	lange
LANKA	lanka
LANKART	lonkart
LANKSTAF	longstaff
LANKTVN	lankton
LAN	laan
LAN	lan
LAN	lann
LAN	lon
LANR	lanner
LANR	lauener
LANSDYL	lonsdale
LANSFRD	lunsford
LANS	lance
LANSTZ	lancetes
LANSYNG	lancing
LANTA	lanetta
LANT	lanett
LANTLVSAMAD	lantlosamade
LANTRMAN	lanterman
LANTZ	lantz
LANTZ	luntz
LANVM	lannom
LANVSY	lanusse
LANY	lani
LANY	lannie
LANZ	lange
LAPASV	lapaso
LAP	lap
LAPLAYN	laplaine
LAP	lopp
LAPVRD	lapworth
LAPVRS	lapworth
LAPVRT	lapworth
LAPVTA	laputa
LAPVVRS	lapworth
LAPYDARY	lapidary
LAPYSKV	luppescu
LARA	lara
LARALY	laralee
LARDYNGA	flardinga
LARJA	larga
LARJ	large
LARN	larren
LARNS	lawrance
LARNS	lawrence
LARSN	larson
LARSN	laursen
LARSVN	larson
LARTR	larter
LARVC	laroche
LARVKVYH	larocque
LARV	larue
LARVRL	larurel
LARYF	lareef
LARYSA	larissa
LARYVYR	lariviere
LARZ	large
LASKALA	lascala
LASKA	laska
LASKARY	lascari
LASK	lusk
LASKVS	laskos
LAS	las
LAS	lash
LAS	loss
LASNYK	lasnik
LAST	last
LASTRA	lastra
LASTR	luster
LASTRY	lustri
LASTYNG	lustig
LASVN	larson
LASYNGR	losinger
LATALA	latala
LATA	latta
LATAM	latham
LATBRY	lathbury
LATBVRY	lathbury
LATKYNZ	lutkins
LAT	lott
LATZ	lutz
LAVANDH	lawande
LAVAYN	lavigne
LAVD	loud
LAV	lau
LAV	law
LAVLS	lawless
LAVMN	loveman
LAVNKA	hlavenka
LAVNYVS	lavonius
LAVRAY	lawrie
LAVRNS	lawrence
LAVSTAD	lovstad
LAVTN	lawton
LAVTVN	lawton
LAVYGNH	lavigne
LAVYN	lavigne
LAVYT	lovitt
LAVZAK	lauzac
LAYAN	lian
LAYBS	lysbethje
LAYBZ	libes
LAYDVYNA	lidwina
LAYDYA	lydea
'LAYDYN	alaaldin
LAYHV	laiho
LAYKZ	likes
LAY	lai
LAYL	lyle
LAY	lye
LAYMAK	limace
LAYMB	limb
LAYND	linde
LAYNG	laing
LAYN	ligne
LAYN	lynn
LAYRD	laird
LAYTBRN	lightburn
LAYTMN	lightman
LAYTNYNG	lightning
LAYV	lao
LAYV	lau
LAYV	liewe
LAYVLY	lively
LAYVRYTSN	lauritsen
LAYVSAY	livesay
LAYVVY	lieuwe
LAYVY	liewe
'LAYYN	alain
LAZARA	lazara
LAZARD	lazard
LAZARV	lazzaro
LBANRD	libannord
LBANVRD	libannord
LBDAN	labdon
LBDVN	labdon
LBN	leben
LBRYNYDYS	labrinidis
LBVN	lebon
LBVR	labore
LBVRT	lapworth
LCLH	lechelle
LCMN	lachman
LCMR	lechmere
LCNR	lechner
LDFVRD	ledford
LDJ	ledge
LDK	ladak
LDVAYDJ	ledwidge
LDVYK	lodewijk
LF	leff
LFLR	leffler
LFTVS	loftus
LG	legg
LHAN	lehan
LHLH	lehle
LHMAN	lehman
LHMAN	lehmann
LHMN	lehman
LHMN	lehmann
LHNRR	lehnerer
LHRNTZ	lohrentz
LHRYAN	lehrian
LHYJ	lahij
LHY	lahij
LJ	ledge
LKAMBR	lecomber
LKRN	lecren
LKRVS	lacross
LKS	lax
LKSN	lection
LKVST	lacoste
LKY	leckie
LMBRN	lamborn
LMBRN	lambourne
LMBRT	lambert
LMBVRNH	lambourne
LMBVRN	lamborn
LMBVRN	lambourne
LMBVVRN	lambourne
LM	lam
LMP	lamp
LMPYNG	lamping
LMRZ	lamers
LMVN	lemon
LMYR	lemer
LNDAHL	landahl
LNDAVR	landauer
LND	land
LNDRY	landry
LNDRZ	landers
LNDVAY	lendvai
LNDY	landi
LNDYN	landin
LNDYNV	lendino
LNDZ	lands
LNGLY	langley
LNGLYNG	lengeling
LNGMYD	langmaid
LNGMYD	langmead
LNGSS	langseth
LNGSTN	langston
LNGSTVN	langston
LNKY	lenkei
LNLVSAMAD	lantlosamade
LNLVZAMYD	lantlosamade
LNNDN	lewendon
LNRT	lehnert
LNS	lence
LNSVN	lanson
LNTLVSAMAD	lantlosamade
LNTLVSAMYD	lantlosamade
LNTYN	lentin
LPARD	lepard
LPART	leppart
LPLA	leppla
LP	lap
LPVRS	lapworth
LPVRTA	laporta
LPVVRS	lapworth
LRAP	lerup
LRBZ	lerbs
LRD	lord
LRMN	lerman
LSARD	lessard
LSLY	lashley
LSR	lesher
LSR	lesser
LST	lesht
LSYAK	lesiak
LTBRY	lathbury
LTJY	fletje
LTRYJ	lotridge
LTV	leto
LVALAY	lavalie
LVATS	loats
LVAYNGH	luinge
LVAYNJ	luinge
LVAYN	levine
LVBV	lobo
LVBVTYN	louboutin
LVBYN	lubin
LVC	loch
LVDMN	lodman
LVDVRF	ludorf
LVDVVYKA	ludovica
LVDVVYKAS	ludovicus
LVDVYJK	lodewijk
LVDVYKA	ludovica
LVDVYKAS	ludovicus
LVDVYK	lodewijk
LVDVYKS	ludovicus
LVDVYKVS	ludovicus
LVDVYSVS	ludovicus
LVFARV	lofaro
LVFASV	lofaso
LVFBARV	loofburrow
LVFR	lupher
LVFSTRVM	lofstrom
LVGH	loughe
LVGNDRA	logendra
LVGZ	loges
LVJYK	logic
LVKA	lukka
LVKARD	lockard
LVKAS	lucas
LVK	locke
LVK	lok
LVK	loke
LVK	look
LVK	luk
LVK	luke
LVKN	loken
LVKS	lukes
LVKSTVN	luxton
LVKV	loco
LV	lau
LV	loo
LV	low
LVMAS	lomas
LVMBARDV	lombardo
LVML	lommel
LVM	lum
LVMN	lowman
LVNAN	lonon
LVNAV	lunau
LVNDAN	lewendon
LVND	lund
LVNDVN	lewendon
LVNJ	luinge
LVN	lon
LVN	lonn
LVNLY	lonely
LVNMV	lonnemo
LVNYG	luinge
LVNY	loney
LVNY	lonnie
LVNY	lownie
LVNYNGDAL	lonningdal
LVNZ	lones
LVNZ	lunz
LVPATKYN	lupatkin
LVP	loop
LVPR	luper
LVPRSTY	lopresti
LVPYN	lupien
LVPZ	lopez
LVRA	laura
LVRA	lora
LVRC	lorch
LVRD	lord
LVRJYV	lorgio
LVRNA	loreena
LVRN	loren
LVRNS	lawrence
LVRNT	laurent
LVRNTZN	lorentzen
LVRNZ	lorenz
LVRNZN	lorenzen
LVRNZV	lorenzo
LVRNZY	lorenzi
LVRTVN	lorton
LVRTY	loreti
LVRY	lawrie
LVRY	loarie
LVRY	lori
LVRY	lory
LVRY	lurie
LVSANTVS	losantos
LVS	los
LVS	luce
LVSMVR	loosmore
LVSRV	lucero
LVSSKV	losecco
LVST	losset
LVSTR	luster
LVSTY	lusty
LVSYH	lucie
LVSY	lucey
LVSY	lucie
LVSY	lucy
LVSYTV	losito
LVTBG	luttbeg
LVTMPYV	lotempio
LVTR	luther
LVTYNZ	lutins
LVTZ	lutz
LVVRA	lovera
LVVRJAT	lauverjat
LVVT	louvet
'LVY	allaway
'LVY	alleway
LVYD	loyd
LVY	levey
LVY	levi
LVYNDN	lewendon
LVYNG	luinge
LVYN	levine
LVYN	lewin
LVYNSVN	levinson
LVYS	lewis
LVYSYLY	loiselle
LVYSYVR	leviseur
LVYYNGH	luinge
LVYYNG	luinge
LVYYSALY	loiselle
LVYYZV	loizzo
LVYZ	lewis
LVZANV	lozano
LVZYR	lozier
'LYA	aaliyah
'LY	aali
'LYA	alia
'LYA	aliya
'LYA	alya
LYA	lea
'LY	ali
'LY	allee
LYAM	liam
LYANG	liang
LYANZ	lianez
LYAV	liao
LYBANNRD	libannord
LYBANVRD	libannord
LYBCN	liebchen
LYBL	lebel
LYBLYT	liblit
LYBMN	liebman
LYBRCAK	liberchuk
LYBRG	laberge
LYBRN	lebrun
LYBRTY	liberty
LYBRYK	librik
LYBSKAMB	lipscombe
LYBSN	liebson
LYBVRN	leybourne
LYBVYTZ	leibowitz
LYBYD	lebed
LYBY	libbey
LYCARSVN	licharson
LYCFYLD	litchfield
LYC	leach
LYCMR	lechmere
LYCTN	lichten
LYCVRVYYS	lichorowic
LYDAL	lidal
LYDA	lydea
LYD	lade
LYDMAN	lademann
LYDN	leyden
LYDN	leythen
LYDRAK	leatherock
LYDRDRAP	leiderdorp
LYDRDRP	leiderdorp
LYDRDRVP	leiderdorp
LYDRDVRP	leiderdorp
LYDR	leeder
LYDVR	lidor
LYDVYNA	lidwina
LYDYA	lydea
LYDYA	lydia
LYFAYV	lefaive
LYGYV	liggio
LYHY	leahy
LYK	leake
LYKYVRY	liquori
LYLA	leila
LYLA	lila
LYLA	lylah
LY	lau
LYLBK	lilback
LY	lea
LY	lee
LY	lei
LY	ley
LY	lie
LYLY	lilley
LYLY	lilli
LYLYND	leelynde
LYLYNTAL	lilienthal
'LYMA	alima
'LYM	alim
'LYMA	ulima
LYMBAX	limbach
LYMBVRG	limburg
LYM	lim
LYMN	lymn
LYMR	limmer
LYMYNG	liming
'LYN	alain
LYNAN	lennon
LYNARS	linares
LYNDAL	lindal
LYNDAN	lyndon
LYNDBK	lindback
LYNDBRG	lindberg
LYNDGARD	lindgard
LYNDGRN	lindgren
LYNDHLM	lindholm
LYND	lind
LYND	linde
LYNDL	lendl
LYNDL	lyndel
LYNDMN	lindemann
LYNDMN	lindman
LYNDN	linden
LYNDNMVT	lindenmuth
LYNDR	linder
LYNDRMN	linderman
LYNDRVTS	lindroth
LYNDSY	lindsey
LYNDVN	lyndon
LYNDZ	lynds
LYNDZY	lindsey
LYNGAS	lingus
LYNGLY	lingley
LYNHAN	linehan
LYNH	lynne
LYNKH	lincke
LYNK	link
LYNKLN	lincoln
LYNKVLN	lincoln
LYNKVYS	linkous
LYN	laine
LYN	lehne
LYN	lien
LYN	lin
LYN	lyn
LYN	lynn
LYN	lynne
LYNSTRAT	linstruth
LYNVAL	lindvall
LYNVNN	leinonen
LYNVRA	leonora
LYPARD	lippard
LYPKYN	lipkin
LYPSKAMB	lipscombe
LYPSKMB	lipscombe
LYPSKM	lipscombe
LYPSKVMB	lipscombe
LYPSKVMP	lipscombe
LYPST	lipset
LYPYJ	lepage
LYR	leair
LYR	lier
LYRN	liren
LYRYKAL	lyrical
LYRYK	lyric
LYSBTH	lysbethje
LYSBTJH	lysbethje
LYSBTJ	lysbethje
LYSBTJY	lysbethje
LYSKANV	liscano
LYSKMB	lipscombe
LYSKN	lisken
LYSKY	liskey
LYS	leas
LYSN	leason
LYSN	leythen
LYSTR	lister
LYSTVN	liston
LYSVN	lison
LYSVN	lisson
LYSY	lacy
LYSYN	lesesne
LYT	litt
LYTL	litel
LYTLTVN	littleton
LYTLY	lytle
LYTMN	littmann
LYTN	leythen
LYTRL	littrell
LYTV	leto
LYTVN	leighton
LYTVN	leyton
LYTVYN	litvin
LYVA	liewe
LYVANDN	lewendon
LYVANDVN	lewendon
LYVAYN	levine
LYVBVNY	lyubovny
LYVH	liewe
LYV	leeuw
LYV	liau
LYV	lieuwe
LYV	liewe
LYV	liow
LYVNARD	leonard
LYVNARDV	leonardo
LYVNDVN	lewendon
LYVNGVD	livengood
LYVN	leon
LYVNL	lionel
LYVNSBRY	lounsbery
LYVNVRA	leonora
LYVNZ	lions
LYVVH	lieuwe
LYVV	lieuwe
LYVY	liewe
LYVYNGSTVN	livingston
LYVYN	levine
LYVYN	livian
LYVYS	lewis
LYVYV	liviu
LYVYVS	livius
LYVYVY	levavy
'LYYAH	aaliyah
LYYL	lyell
LYYVVH	lieuwe
LYZA	lisa
LYZA	lissa
LYZARD	lizard
LYZARDZ	lizards
LYZBTY	lysbethje
LYZ	liz
LYZN	lesion
LYZR	laser
LYZVT	lizotte
MABANAG	mabanag
MABAY	mawby
MABY	mawby
MAC	much
MACTLD	machteld
MADABA	madaba
MADAKS	maddux
MADJ	madej
MADLYN	madeleine
MADLYN	madeline
MADLYN	madelyn
MADN	madden
MADRVN	madrone
MADSN	madsen
MADVN	madon
MADVRAY	madurai
MADYGAN	madigan
MADY	maddi
MADYS	madis
MADYSVN	madison
MADYV	madeo
MAFRY	maffray
MAFYN	muffin
MAGAGNA	magagna
MAGARD	maggard
MAGDALYNTH	magdaleentje
MAGD	mogged
MAGLYRV	magliaro
MAGR	mager
MAGRVDR	magruder
MAGS	maggs
MAGVAYR	maguire
MAGVYR	maguire
MAGYL	magill
MAHADVAN	mahadevan
MAHAJAN	mahajan
MAHALT	mahault
MAHALY	mahaly
MAHA	maha
MAHAVLT	mahault
MAHTV	mahto
MAHVLT	mahault
MAHVT	mahault
MAJV	majoe
MAJY	majee
MAJYV	maggio
MAKARAYG	macaraeg
MAKAYVLY	macauley
MAKK	macek
MAKLAQLYN	maclaughlin
MAK	mack
MAK	mak
MAK	mawk
MAKRYJ	mockridge
MAKSVL	maxwells
MAKSY	maxi
MAKSYM	maxim
MAKSYMYLYAN	maximilian
MAKV	macko
MAKVMBR	macomber
MAKVNVCY	maconochie
MAKVSY	macucci
MAKY	mackay
MAKYNVN	mackinnon
MAKYRAS	mackerras
MAKYSAK	macisaac
MAKZYM	maxim
MALAMVD	malamood
MALAN	malan
MALBRG	malberg
MALD	malde
MALDN	moulden
MALKVK	mallchok
MALKVM	malcolm
MALN	malone
MALNR	malnar
MALRVNY	mulrooney
MALTYN	maltin
MALVN	malone
MALVNY	malone
MALYGAN	mulligan
MALYK	mallick
MAMA	mama
MAMFVRD	mumford
MAMN	mammen
MAMRT	mummert
MAMY	maumee
MANAMA	manama
MANA	mana
MANA	manna
MANBR	manber
MANC	munch
MANDAL	mandal
MANDA	manda
MANDAR	mondor
MANDAVYL	mandaville
MANDL	mandel
MANDR	mandar
MANDY	munday
MANGAN	mangan
MANGLANY	manglani
MANGR	monger
MANGYN	mangin
MANJYT	manjeet
MANJYT	manjit
MANKA	manca
MANK	monk
MANKRT	munkert
MANKS	monks
MANKVS	mancus
MANKY	monkey
MANLY	manley
MANMA	manama
MAN	mann
MANRV	munro
MANSN	manson
MANSTR	monster
MANSYL	munsil
MANSYNGR	munsinger
MANTA	manetta
MANTL	mantle
MANTNZ	mountains
MANTRAS	montrose
MANTVR	mantor
MANTYKS	mannix
MANTY	mantey
MANVLY	manoli
MANVLY	manolo
MANV	manno
MANV	mano
MANV	manu
MANV	muno
MANVRY	manoury
MANX	munch
MANYJA	manija
MANYKS	mannix
MANY	mani
MANY	money
MANYNG	manning
MANYSKAS	maniskas
MANYS	manish
MANYT	manith
MANYV	manu
MANZ	manns
MAPARTYDA	malpartida
MAPLZ	maples
MARALY	murali
MARANY	marani
MARAT	marat
MARAZAS	marazas
MARBAC	marbach
MARBL	marble
MARC	march
MARCYNDV	marchiondo
MARDR	marder
MARDVC	murdoch
MARFY	murphy
MARGALTA	margretha
MARGALYTY	margarietie
MARGANTH	marregante
MARGANT	marregante
MARGARTA	margretha
MARGARYTA	margretha
MARGARYTAY	margarietie
MARGARYTJH	margarietje
MARGARYTJ	margarietje
MARGARYTJ	margrietje
MARGARYTJY	margarietje
MARGARYT	margarietie
MARGARYT	margarietje
MARGARYT	margrietje
MARGARYTY	margarietie
MARGLYN	margolin
MARGRTA	margretha
MARGRYJH	margrietje
MARGRYTA	margretha
MARGRYTH	margarietje
MARGRYTH	margrietje
MARGRYTJ	margrietje
MARGRYTJY	margrietje
MARGRYT	margrietje
MARGRYTYH	margarietie
MARGVLYN	margolin
MARGVLYS	margolis
MARGVLYVKS	margulieux
MARJNT	marregante
MARKHAM	markham
MARKLY	markley
MARK	marc
MARK	mark
MARKS	marx
MARKSN	marxen
MARKSTYNR	marksteiner
MARKV	marco
MARKV	markku
MARKVM	marcum
MARKVPVLY	marcopoli
MARKVS	marcos
MARKVS	marcus
MARKVS	marques
MARKVYT	marquette
MARKVYZA	marqueza
MARKVZ	markowitz
MARKYL	markiel
MARKY	markey
MARKYNGTVN	marchington
MARKYYVS	marcus
MARLA	marla
MARLAT	marlatt
MARL	murrell
MARLY	marley
MARLYN	marlin
MAR	mar
MARN	muren
MARPL	marple
MARRL	murrell
MARSAL	marshall
MARSLA	marcela
MARSL	marcel
MARSLV	marcelo
MARSLYNV	marcelino
MARS	mares
MARS	marrs
MARSTVN	marston
MARSY	marcy
MARTL	martell
MARTLND	martland
MARTN	marten
MARTNTJY	martyntje
MARTYJN	martijn
MARTYJN	martijntje
MARTYJNTJH	martijntje
MARTYJNTJY	martijntje
MARTY	marti
MARTY	marty
MARTYNH	martyntje
MARTYNJ	martijntje
MARTYNJ	martyntje
MARTYN	martijn
MARTYN	martyn
MARTYNSN	martinsen
MARTYNTH	martijntje
MARTYNTH	martyntje
MARTYNTJH	martyntje
MARTYNTJ	martyntje
MARTYNT	martijntje
MARTYNT	martyntje
MARTYNV	martino
MARTYNVS	marthinus
MARTYNZ	martens
MARTYNZ	marthinus
MARTYNZ	martins
MARTYZN	martijn
MARTYZNTJ	martijntje
MARTZ	martz
MARVAHA	marwaha
MARVCY	marocchi
MARV	marv
MARVN	maroon
MARVN	marrone
MARVNY	maroney
MARVYN	marvin
MARVYN	marwin
MARVYT	marvit
MARXAM	markham
MARYA	maria
MARYANA	mariano
MARYAN	maryanne
MARYGANTH	marregante
MARYGANT	marregante
MARYH	murie
MARYJH	maritje
MARYJH	marritje
MARYJKN	marijken
MARYJ	maritje
MARYJNT	marregante
MARYKANDV	maricondo
MARYKN	marijken
MARYLYN	marylynn
MARY	mary
MARY	mury
MARYN	marin
MARYNV	marino
MARYSH	maryse
MARYS	maryse
MARYSVN	morrison
MARYTH	maritje
MARYTH	marritje
MARYTJ	maritje
MARYTJ	marritje
MARYTJY	maritje
MARYTJY	marritje
MARYT	maritje
MARYT	marritje
MARYV	mario
MARYVS	marius
MARYYANY	mariani
MARYZ	maryse
MARZK	marzec
MARZ	marz
MASAHYRV	masahiro
MASARA	masaru
MASATAKA	masataka
MASATV	masato
MASAYV	masao
MASBRG	mossburg
MASKARY	mascari
MASKL	maskell
MASK	masek
MASKYAS	mascias
MASLD	machteld
MASLLY	masselli
MASNA	masna
MASNA	masnaa
MASRMN	masserman
MASTN	masten
MASTYR	mashtare
MASVN	masson
MASYK	maciek
MASY	mashey
MASYMV	massimo
MASYN	machine
MATAKV	matako
MATA	mata
MATANA	matana
MATAR	matar
MATAY	mathai
MATJKA	matejka
MATLV	mutlu
MAT	mutt
MATSVDA	matsuda
MATSVMVTV	matsumoto
MATSVN	mattson
MATVLA	matula
MATV	mattu
MATVR	mathur
MATVS	matthews
MATYNV	mautino
MATYS	matheis
MATYS	mattis
MATYV	matthew
MATYVS	matthews
MAVBAY	mawby
MAVBY	mawby
MAV	mao
MAV	mau
MAV	maw
MAVN	maun
MAVPYN	maupin
MAVR	mauer
MAVRS	mavers
MAVSR	mouser
MAX	mach
MAYFYLD	mayfield
MAYKLYS	michaelis
MAYKLZN	micheltjen
MAYK	mike
MAYKN	micohn
MAYKVHN	micohn
MAYKVK	maycock
MAYLN	milne
MAY	mai
MAY	may
MAYMVN	maimone
MAYNDRT	meindert
MAYN	maine
MAYN	mayeen
MAYNR	miner
MAYR	mayr
MAYR	meyer
MAYR	mire
MAYR	moyer
MAYR	myer
MAYRN	myreen
MAYRS	myers
MAYRYK	myrick
MAYRZ	myers
MAYSAL	missal
MAYSA	myiesha
MAYSL	missel
MAYSTYK	mystic
MAYTAG	maytag
MAYTHAM	mitham
MAYT	might
MAYT	myth
MAYTY	mighty
MAYVHAY	maohai
MAYV	mayo
MAYZ	mize
MAZRA	mazera
MBARK	mubarak
MCLD	machteld
MCTLD	machteld
MDABA	madaba
MDAVR	medawar
MDBA	madaba
MDH	madah
MDLYN	medlin
MDNYK	mednick
MDNYT	madinat
MDRK	medrek
MDRR	maderer
MDS	mads
MDSN	madsen
MDSVN	madsen
MDVNA	muthanna
MDYNA	medina
MDYNH	madinat
MDYNH	medina
MDYN	median
MDYNNY	maddineni
MDYNT	madinat
MDYSVN	maddison
MDYSVN	madison
MFRG	mafraq
MFRK	mafraq
MFRVK	mafraq
MGDALNT	magdaleentje
MGDALYNTJ	magdaleentje
MGDALYYNTJH	magdaleentje
MGDA	magda
MGDAYNTJ	magdaleentje
MGLAGLYN	maclaughlin
MGLAT	maglott
MGNAN	magnan
MGNASN	magnuson
MGNH	magne
MGNY	magne
MGR	meger
MGY	magee
MGY	maggi
MGY	maggie
MGYNL	maginel
MGYS	magesh
MGYSY	megyesi
MGYV	maggio
MHADVAN	mahadevan
MHAMA	muhamma
MHARAK	muharraq
MHL	mehl
MH	mah
MHMA	muhamma
MHRAH	mahrah
MHRA	mahrah
MHRG	muharraq
MHRH	mahrah
MHRK	muharraq
MHRM	muharraq
MHVYT	mahwit
MJDL	majdal
MJ	maj
MJYA	mejia
MJYD	majid
MJYKAL	magical
MJYK	magic
MKAH	mekkah
MKALYR	mcaleer
MKA	mecca
MKARDL	mcardle
MKDALN	magdaleentje
MKDRMVT	mcdermott
MKDVLND	macdonald
MKDVNALD	macdonald
MKDVNALD	mcdonald
MKDVYL	mcdowell
MKFARLND	mcfarland
MKFARLYN	macfarlane
MKFRLYN	mcfarlane
MKGAVYN	mcgavin
MKGRAT	mcgrath
MKGVVAN	macgowan
MKGVYRK	mcguirk
MKGVYR	mcguire
MKGYRY	mcgeary
MKH	mecca
MKH	mekkah
MKHNRY	mchenry
MKKAH	mekkah
MKKAN	mccann
MKKARTY	mccarthy
MKKARTY	mccarty
MKKAVN	mccown
MKKNA	mckenna
MKKNY	mckenney
MKKNZY	mckenzie
MKKRKN	mccracken
MKLAGLYN	maclaughlin
MKLAQLYN	maclaughlin
MKLARN	maclaren
MKLAVLYN	maclaughlin
MKLAVLYN	mcloughlin
MKLAVVGYNG	maclaughlin
MKLYN	maclean
MKLYN	mclean
MK	mac
MK	mack
MKMAHAN	mcmahan
MKMAHVN	macmahon
MKMAHVN	mcmahon
MK	mak
MKMANYS	mcmanis
MKMVLN	mcmullen
MKMYLAN	macmillan
MKNAT	mcnutt
MKNYL	macneil
MKNYL	mcneill
MKRA	macra
MKRAYH	macrae
MKRAY	macrae
MKRDY	macready
MKRVN	macrone
MKRYS	macris
MKSFYLD	maxfield
MKSN	macsen
MKSYMV	maximov
MKTAVYS	mactavish
MKVC	makuch
MKVTV	makoto
MKVY	mackay
MKVY	macvoy
MKYL	makil
MKY	macky
'ML	amal
MLA	mella
MLANDR	melander
MLANY	melanie
MLAYYR	molaire
MLBAY	melby
MLCR	melcher
MLCYR	melchior
MLKA	melka
MLKVLM	malcolm
MLKVM	malcolm
MLMN	melman
MLN	melen
MLR	mellor
MLTH	malte
MLV	melo
MLVN	meloon
MLVR	mellor
MLYBV	malibu
MLYDY	meleedy
MLY	malay
MLYNGR	mellinger
MLYN	mellin
MLYNY	malini
M'MA	muhamma
MMH	mame
MMTA	mamta
MNAMA	manama
MNAMH	manama
MNARD	menard
MNDL	mandl
MNDL	mandle
MNDL	mendell
MNDR	mandar
MNDVZA	mendoza
MNDYBL	mandible
MNDYK	mendyke
MNDY	mandy
MNDZ	mendes
MNFVL	manfull
MNGAN	mangan
MNGH	menge
MNG	meng
MNGS	mangus
MNHART	menhardt
MNH	mane
MNJYVN	mangione
MNK	menke
MNKVSV	mancuso
MNKYVS	mancuso
MNMA	manama
MNNYNG	manning
MNRV	monroe
MNSA	mansa
MNSN	manson
MNSTRYNA	menestrina
MNSVR	mansoor
MNSVR	mansour
MNSVR	mansur
MNSVRY	mansuri
MNTL	mantle
MNT	menth
MNTQH	mintaqah
MNTSR	mentzer
MNTSYNN	mantsinen
MNTY	manti
MNTZR	mentzer
MNYJR	manager
MNYKS	mannix
MNY	manny
MNY	many
MNYNG	manning
MNYN	manin
MNZR	mounzer
MNZS	menezes
MNZYZ	menzies
MPL	maple
MPL	mapple
MQBRH	moqbara
MQRBY	moghrabi
MQSVD	maqsood
MRANDA	meranda
MRDYS	meredith
MRDYT	meredith
MRHAVS	morehouse
MRJYNYV	merginio
MRKL	merkel
MRKLY	merkle
MRKNT	merchant
MRKR	mercer
MRNDA	maranda
MRNY	maroney
M'RQ	muharraq
MRSR	mercer
MRSRYA	mersereau
MRSRYV	mersereau
MRTN	morton
MRTNZ	mertens
'MR	umar
MRVAH	marwah
MRVAN	marwan
MRYGAN	merrigan
MRYJ	marritje
MRYK	merrick
MRYKS	merricks
MRYMAN	merriman
MRY	maury
MRY	merry
MRYMN	merriman
MRYNLY	marinelli
MRYS	maryse
MRYT	meritt
MRZ	merz
MSALXY	masalkhi
MSA	mesa
MSANDR	mesander
MSBARN	mashburn
MSKS	meskes
MSKYN	miskin
MSLYN	maslin
MSMAN	mossman
MSR	messer
MSS	moses
MSTAN	mastan
MST	mast
MST	mest
MSTRZ	masters
MS'VD	masud
MSYF	massif
MSYNA	messina
MSYNGR	messinger
MSYN	masin
MSYVS	massios
MTANA	matana
MTLYN	matlin
MT	mat
MT	matt
MTNA	matana
MTNA	muthanna
MTRNC	metternich
MTRNYC	metternich
MTRV	matrow
MTRYNC	metternich
MTSGR	metzger
MTSVMVTV	matsumoto
MTSVN	matheson
MTVR	mathur
MTYN	mateen
MTYN	matin
MTYV	mathew
MTYV	mathieu
MTYV	matthew
MTYVS	matthews
MTYVS	matyas
MTYVSVN	matthewson
MTYVZ	matthews
MTZGR	metzger
MTZYNG	metzing
MVALR	mueller
MVANZR	muenzer
MVBAY	mawby
MVBLY	mobley
MVDGYL	moudgill
MVD	mod
MVDY	moody
MVDY	mudie
MVFAD	moffat
MVGANTY	moganti
MVHAMA	muhamma
MVHAN	mohan
MVHR	mohar
MVKASA	mukasa
MVK	mok
MVKRYJ	mockridge
MVLANDR	molander
MVLDN	moulden
MVLK	moulk
MVL	moll
MVLN	moulden
MVLR	moller
MVLR	muller
MVLVY	molloy
MVLYGAN	mulligan
MVLY	mouli
MVLYNARY	molinari
MVMFVRD	mumford
MV	muh
MVNAGAN	monagan
MVNAK	monack
MVNAKV	monaco
MVNAZ	munoz
MVNDFRANS	mondfrans
MVNDVR	mondore
MVNKAR	moncur
MVNK	monk
MVNKS	monks
MVNKZ	monks
MVN	moon
MVN	mun
MVNRV	munro
MVNS	muns
MVNTAG	montag
MVNTAGV	montagu
MVNTALBANV	montalbano
MVNTA	monta
MVNTANARV	montanaro
MVNTANV	montano
MVNTGMRY	montgomery
MVNTGVMRY	montgomery
MVNT	mount
MVNTRAL	montreal
MVNTRV	montero
MVNTVYA	montoya
MVNTYJV	montijo
MVNVLYT	monolith
MVNYZ	muniz
MVNZLR	muenzler
MVRABYTV	morabito
MVRAD	murad
MVRAL	morreale
MVRALS	morales
MVRALT	muralt
MVRA	mura
MVRANDV	morando
MVRAN	moran
MVRANV	morano
MVRAS	moras
MVRAVAN	moravan
MVRAY	moray
MVRAYNS	moraines
MVRC	morch
MVRDAC	murdoch
MVRDAK	murdoch
MVRFY	murphy
MVRHAVS	moorhouse
MVRHAVS	morehouse
MVRKL	morkel
MVRKN	morken
MVRLAN	morlan
MVRL	morel
MVRL	morrell
MVRL	murrell
MVRLYJ	morlidge
MVRLY	morley
MVRMAN	moorman
MVR	moore
MVRNYNG	morning
MVRS	mores
MVRS	morse
MVRS	morss
MVRSTAD	maurstad
MVRTAN	morton
MVRTN	morton
MVRTVN	morton
MVRTYMR	mortimer
MVRTYMR	mortimore
MVRTY	murthy
MVRTYMVR	mortimore
MVRV	mauro
MVRVNY	moroney
MVRVYL	morville
MVRYL	morrill
MVRY	moore
MVRY	morey
MVRYN	morin
MVRYSN	morrison
MVRYSVN	morison
MVRYSVN	morrison
MVRYTA	morita
MVSAL	muschall
MVSANA	muthanna
MVSFYS	mooseface
MVSLA	musella
MVSMN	mossman
MVS	muse
MVSVN	muysson
MVSVY	moosavi
MVSYG	muessig
MVSY	musa
MVSYR	moshier
MVSYVN	muysson
MVSZ	mosses
MVTA	motta
MVTANA	muthanna
MVT	mott
MVTVR	motor
MVTVRZ	motors
MVTYSV	mutiso
MVVR	moore
MVYL	moile
MVY	moye
MVYNYHAN	moynihan
MVYNZ	moynes
MVYR	muir
MVYSAN	muysson
MVYS	muise
MVYSS	moises
MVYSVN	muysson
MVYZ	muise
MVYZVN	muysson
MVZYNA	mozina
MVZZ	moses
MYAV	miao
MYAYNDRT	meindert
MYCALYS	michaelis
MYCA	micha
MYCAN	meechan
MYCAYLYS	michaelis
MYCL	mitchell
MYCLTJN	micheltjen
MYCLTN	micheltjen
MYCLTYN	micheltjen
MYCLYS	michaelis
MYCN	meachen
MYDLBRV	middlebro
MYDLTN	middleton
MYDLTVN	middleton
MYD	medd
MYDR	mader
MYDY	medea
MYGN	meighen
MYGNRAN	migneron
MYGNRY	mignerey
MYGR	mager
MYGR	meagher
MYGVYL	miguel
MYHALYK	mihalick
MYHAN	meehan
MYJR	meijer
MYJRY	majere
MYKAK	maycock
MYKALK	michalak
MYKA	mekkah
MYKAS	mikoss
MYKAYL	mikael
MYKAYYL	mickhael
MYKAYYLYZ	michaelis
MYKAYYLZ	michaelis
MYKK	maycock
MYKLACLN	maclachlan
MYKLJN	micheltjen
MYKLM	micklem
MYKLSN	mikkelsen
MYKLSVN	mickelson
MYK	meek
MYKNA	mickna
MYKR	meaker
MYKS	meeks
MYKS	mikus
MYKS	mix
MYKT	miket
MYKVK	maycock
MYKVLYK	mikolic
MYKV	mikko
MYKYNG	meekings
MYKYNZ	meekins
MYKZ	meeks
MYLAD	milad
MYLAM	milam
MYLAM	millham
MYLAN	millan
MYLARA	melara
MYLARD	millard
MYLAR	millar
MYLASYS	milacic
MYLBRT	milbert
MYLDRD	mildred
MYLGRAM	milgram
MYLKS	milks
MYLKV	milko
MYLKY	milky
MYLMAN	melman
MYLMAN	millman
MYLMV	milmoe
MYLN	melen
MYLNR	milner
MYLNVR	milnor
MYLNYVM	millennium
MYLR	miller
MYLSTVN	milestone
MYLT	millett
MYLT	milt
MYLTN	milton
MYLVARD	milward
MYLV	milo
MYLVS	milos
MYLVT	milut
MYLYANZ	millians
MYLYGAN	milligan
MYLYKN	millican
MYLY	milley
MYLY	milli
MYLY	millie
MYLYND	milind
MY	mai
MYMAS	mimas
MY	may
MY	mei
MYMY	mime
MYNA	mina
MYNA	minna
MYNAMV	minamo
MYNARD	maynard
MYNARD	menard
MYNARYK	minarik
MYNDRT	meindert
MYNGV	mingo
MYNKY	minqi
MYN	main
MYN	maine
MYN	mayne
MYN	mean
MYN	min
MYNRAL	mineral
MYNR	miner
MYNRVA	minerva
MYNRZ	meiners
MYNSR	mincer
MYNSTRL	minstrel
MYNSY	mincey
MYNTAKAH	mintaqah
MYNTAKVA	mintaqah
MYNTKA	mintaqah
MYNT	mindt
MYNTR	minter
MYNTVN	minton
MYNTZ	mintz
MYNVARYNG	mainwaring
MYNYARD	minyard
MYNY	meaney
MYNZ	mains
MYNZ	menes
MYPL	maple
MYRA	meara
MYRA	miura
MYRANKR	miranker
MYRFLD	mayerfeld
MYR	mair
MYRMAK	mirmak
MYR	meyer
MYR	mier
MYR	mir
MYRS	mears
MYRSY	mirashi
MYRTY	mirti
MYRVA	mierwa
MYRVL	merolle
MYRVT	mirut
MYRYDYT	meredith
MYRZ	mears
MYRZ	meyers
MYRZ	myers
MYSA	mesa
MYSA	myiesha
MYSAN	maysan
MYSAT	measat
MYSLAV	mislove
MYSL	michele
MYSL	mitchell
MYSM	maysan
MYSN	maysan
MYSRA	misra
MYSTRY	mistry
MYSTYK	mistick
MYSVNR	masoner
MYSYK	misik
MYTAL	mithal
MYTAVA	maitawa
MYTCL	mitchell
MYTCM	mitchem
MYTNYK	mitnick
MYTRVVYK	mitrovic
MYTSL	mitchell
MYTV	mito
MYTV	mitu
MYTVN	maton
MYTVNN	miettunen
MYV	mayo
MYVS	meewes
MYVSN	muysson
MYVVZ	meewes
MYVZ	meewes
MYVZR	meuser
MYYH	miehe
MYYR	meier
MYYRS	meyers
MYZ	maze
MYZ	mize
MYZVN	maison
MYZYRA	mizera
MZDH	mazdeh
MZYK	magic
MZYVN	magion
NAB	knob
NABL	noble
NABYL	nabil
NADAN	nathan
NADANSVN	nathanson
NADVLNY	nadolny
NADYG	nadig
NAF	knaff
NAF	knauff
NAF	knoph
NAFZA	nafeeza
NAGASAKY	nagasaki
NAGASYVA	nagasiva
NAGNT	nugent
NAGY	nagy
NAHAM	nahum
NAJR	nager
NAJYAH	najiyah
NAJYA	najya
NAKAGAKY	nakagaki
NAKAMVRA	nakamura
NAKASVRA	nakasora
NAKASYMA	nakashima
NAK	knoke
NAKSVN	noxon
NAKVYYN	naquin
NAL	knoll
NALYK	nallick
NAM	nam
NANDVANY	nandwani
NANLY	nunley
NAN	nan
NANS	nance
NANSY	nancy
NANTVN	naunton
NAP	knapp
NAP	knop
NAPTVN	napton
NAPVLYTANV	napolitano
NARAD	narad
NARDN	nardone
NARDV	nardo
NARDY	nardi
NARLA	narla
NARSAVAG	narsavage
NARV	naro
NASAV	nassau
NAS	nas
NAS	nass
NATAN	nathan
NAT	nutt
NATSN	knutsen
NAVAR	nawar
NAVARV	navarro
NAVAS	navas
NAV	nau
NAV	nave
NAVYA	navia
NAVYLV	novillo
NAYA	nina
NAYDV	naidoo
NAYFH	nayfeh
NAYFLR	nyffeler
NAYKRBYKR	knickerbacker
NAYKS	nix
NAYKS	nyikos
NAYKVLAS	nicolaes
NAYLR	naylor
NAYLZ	niles
NAYMAH	naimah
NAYRMN	niermann
NAYT	knight
NAYT	night
NAZAHA	nazahah
NAZARYTYAN	nazaretian
NAZARYV	nazario
NBATAY	nabatiye
NBATYH	nabatiye
NBATY	nabatiye
NBL	nebel
'NBR	anbar
NBRS	nebres
NDA	nida
NDKARNY	nadkarni
NDN	neden
NDVD	nedved
NDYN	nedin
NFAN	neefjan
NFDV	nefedow
NFJAN	neefjan
NFL	knefel
NFYSA	nafeeza
NFYZA	nafeeza
NFZA	nafeeza
NGTYV	negative
NGY	nagy
NHAVS	neuhaus
NHNH	nahnah
NJAF	najaf
NJF	najaf
NJVA	najwa
NJYAH	najiyah
NJYA	najya
NJYH	najiyah
NKLAS	niklas
NKLS	niklas
NKNZ	niknaz
NKV	nicko
NKV	nico
NL	knel
NLKYN	nelkin
NLS	nils
NLSN	nilsen
NLT	neeltje
NMAZY	namazi
NPAN	nippon
NP	knapp
NPL	nipple
NPR	knepper
NPTVN	napton
NPVRA	napora
NRAD	narad
NRDNFLT	nordenfelt
NRS	nurse
NRTRVP	northorpe
NRVP	norup
NRY	neri
NRY	nery
NSLY	nesley
NSNAL	national
NSVA	nashwa
NSVM	nossum
NSYDA	nashida
NSYHA	nasiha
NSYH	nasiha
NSYRA	nasira
NTAKR	nethacker
NTRTVN	netherton
NTYFA	nathifa
NTYHA	nathifa
NVALA	novella
NVAR	nawar
NVAYL	nevile
NVAZ	nawaz
NVBL	knobel
NVBL	noble
NVDA	noda
NVDYNG	nuding
NVF	knoph
NVGNT	nugent
NVJANS	nevejans
NVJANZ	nevejans
NVJNANS	nevejans
NVJNS	nevejans
NVJNT	nugent
NVKS	knox
NVKV	noko
NVLAN	nolan
NVLD	nolde
NVLF	nolf
NVL	knoll
NVL	nevel
NVNYS	nunis
NVP	knoph
NVRA	nuri
NVRBAY	norby
NVRDA	noorda
NVRDBAY	nordby
NVRDBVRG	nordborg
NVRDDRAP	noorddorp
NVRDNSTVRM	nordenstrom
NVRDRAP	noorddorp
NVRDRVPH	northorpe
NVRDT	nordt
NVRDVRP	noorddorp
NVRDVRP	northorpe
NVRHA	norha
NVRKAT	norcott
NVRN	noren
NVRSRAP	northrup
NVRSVRP	northorpe
NVRTKAT	northcutt
NVRTVRPH	northorpe
NVRTVRP	northorpe
NVRVVD	norwood
NVRY	nuri
NVSAK	nosack
NVSL	kneusel
NVT	nuth
NVTZN	knutzen
NVTZ	notz
NVVALA	novella
NVVRDDRP	noorddorp
NVVSL	novosel
NVVYK	novik
NVYA	noya
NVYFL	knoefel
NVYJANZ	nevejans
NVYK	novick
NVYL	knoell
NVYL	neville
NVYLS	noyles
NVYNGTVN	newington
NVYS	navis
NVZ	nose
NYBY	nibby
NYCVLAS	nicholas
NYCVLS	nichols
NYDAL	nidal
NYDA	nida
NYDH	nida
NYDLZ	needles
NYD	nid
NYFJAN	neefjan
NYFYN	kniffin
NYGLY	niggli
NYG	nigg
NYGRA	nigra
NYGT	knight
NYHALANY	nihalani
NYKALAS	nicolas
NYKLAS	nicholas
NYKLAS	nicolaes
NYKLAS	nicolaus
NYKLAS	niekolaas
NYKL	nickel
NYKL	nickell
NYKL	nicol
NYKL	nicole
NYKLS	nichols
NYKLS	niclas
NYKLS	nicolaes
NYKLS	niklas
NYKLSN	nicholson
NYKLSN	nickelsen
NYKLSVN	nicholson
NYKLV	nicolo
NYKLZ	nicholls
NYKLZ	nichols
NYK	nic
NYK	nick
NYK	niek
NYKRBAKR	knickerbacker
NYKRBKR	knickerbacker
NYKRBYKR	knickerbacker
NYKRSVN	nickerson
NYKS	nikos
NYKSVN	nixon
NYKVLA	nicola
NYKVLAS	nicholas
NYKVLAS	nicolaes
NYKVLAS	nicolas
NYKVLAS	niekolaas
NYKVL	nicoll
NYKVLSAN	nicholson
NYKVLS	nichols
NYKVLS	nicolaes
NYKVLS	nicolas
NYKVLSVN	nicholson
NYKVLYK	nikolic
NYKVLY	nickolay
NYKVLY	nikolay
NYKVLZ	nicholls
NYKVLZ	nichols
NYKV	nico
NYKY	nickey
NYKY	nicki
NYKY	niki
NYKY	nikki
NYLBRY	tilbury
NYLJH	neeltje
NYLMG	neelmegh
NYLND	niland
NYL	neill
NYL	niel
NYLS	niels
NYLS	nilesh
NYLS	nils
NYLS	nilse
NYLTH	neeltje
NYLTJH	neeltje
NYLTJ	neeltje
NYLTJY	neeltje
NYLZ	niels
NYMAH	naimah
NYMA	naimah
N'YMH	naimah
NYMH	naimah
NYMRAD	nimrod
NYMTZ	nimtz
NYMY	niemi
NYNDK	ninedek
NYNJA	ninja
NYN	nien
NYN	nin
NYNS	ninnis
NYNSTAR	ninstar
NYNV	nino
NYNVYS	ninoys
NYPAN	nippon
NYPNBRG	knippenberg
NYPTVN	napton
NYR	nair
NYR	nayar
NYS	ness
NYS	niss
NYSN	neisen
NYSPL	knispel
NYSYLDA	gnishilda
NYTYN	nitin
NYVAN	neuen
NYVARK	newark
NYVAYNGTN	newington
NYVAYNGTVN	newington
NYVBAY	newby
NYVBRY	newberry
NYVBRY	newbery
NYVKVLAS	niekolaas
NYVKVYST	newquist
NYVLND	newland
NYVMAN	neuman
NYVMAN	newman
NYVMN	newman
NYVMYR	newmeyer
NYVSAM	newsham
NYVTN	newton
NYVVYNGTVN	newington
NYVYSVN	nevison
NYVYYNGTVN	newington
NYYVKAMB	newcomb
NYYVTN	newton
'NYZH	unaiza
NZAHAH	nazahah
NZAHA	nazahah
NZAHH	nazahah
NZYRAH	nazirah
NZYRA	nazirah
NZYRH	nazirah
PABLT	poblete
PABLV	pablo
PACVLKH	pacholke
PACYANV	pachiano
PADVA	padua
PADVLA	padula
PADYAL	padial
PADYLA	padilla
PAGLAYS	pugliese
PAGLYA	paglia
PAGLYS	pugliese
PAGLYYARV	pagliaro
PAGT	pagett
PAJT	pagett
PAKALA	pakala
PAKARD	packard
PAKNAS	pakenas
PAKS	paks
PAKS	pax
PAKT	puckett
PAKVAT	paquet
PALAGY	palagyi
PALAK	pallack
PALFVRD	pulford
PALMRT	palmert
PAL	pahle
PAL	pal
PALRMV	palermo
PALSKY	polsky
PALSN	paulsen
PALSYFR	pulsifer
PALTJH	paultje
PALTJ	paultje
PALTJY	paultje
PALVMBV	palumbo
PALYDV	pulido
PALY	paley
PALY	pauli
PALY	pulley
PALYS	pallis
PAMFRY	pumfrey
PAM	pam
PANAGS	panagos
PANAS	panas
PANC	punch
PANDA	panda
PANDR	ponder
PANDVLFYNV	pandolfino
PANDYAN	pandian
PANDYT	pandit
PANDZ	ponds
PANFYL	panfil
PANGBVRN	pangborn
PANJABY	punjabi
PANKRAS	pancras
PANKRS	pancras
PANN	panon
PAN	pan
PANT	pant
PANVALKR	panvalkar
PANVN	pannon
PANYKV	panico
PANYSY	panici
PAPALARDV	pappalardo
PAPAY	papay
PAPLASKAS	paplaskas
PAPLTVN	poppleton
PAPLY	popli
PAPN	poppen
PAP	papp
PAP	pope
PAPVYK	popovic
PAQ	pugh
PARA	parra
PARAT	parratt
PARAYL	parayil
PARDN	pardon
PARDYNGTN	pardington
PARDYNGTVN	pardington
PARDY	pardi
PARDZ	pardes
PARHAM	parham
PARK	park
PARKYN	parkin
PARKZ	parks
PARMAR	parmar
PARNS	parnass
PARSANZ	parsons
PARSL	purcell
PARSN	parson
PARSVNS	parsons
PARSVNZ	parsons
PARTVN	parton
PARTVS	partos
PARTY	partee
PARYNGTVN	pardington
PARY	parry
PARYS	parrish
PASKAL	pascal
PASKV	pasco
PASKV	pasko
PAS	pass
PASTRNAK	pasternak
PASTVR	pastore
PASYFYK	pacific
PASYR	passier
PATN	patten
PATR	potter
PATRSVN	paterson
PATRSVN	patterson
PATRVKLVS	patroclus
PATRYK	patric
PATRYK	patrick
PATRYK	patrik
PATRYS	patrice
PATRYSYA	patricia
PATRYZYV	patrizio
PATS	potts
PATTA	patetta
PATVCY	patocchi
PATVKSNT	patuxent
PATYL	patil
PAVL	pavol
PAVLSN	poulsen
PAVLS	powles
PAVLTH	paultje
PAVLT	paultje
PAVLYK	pavlik
PAV	phua
PAVV	pouw
PAYJ	paige
PAYK	pike
PAYNH	payne
PAYN	payne
PAYNTVN	paynton
PAYNY	payne
PAY	pai
PAYPR	piper
PAYRAMYD	pyramid
PAYTH	pietje
PAYTJ	pietje
PAYTR	pieter
PAYTR	pitre
PAYTVN	payton
PAYVLSVN	paulson
PAYVLTJ	paultje
PAYVTH	paultje
PD	peade
PDRAM	pedram
PDRSN	pedersen
PDRSVN	pedersen
PDY	peade
PG	pegg
PGRAM	pegram
PGT	pagett
PK	pack
PKR	packer
PKYNGZ	perkins
PLAK	plack
PLAMN	plamen
PLAMR	plummer
PLANK	plunk
PLAN	plamen
PLANT	pellant
PLASTYNV	plastino
PLATFVRM	platform
PLAT	plath
PLAT	plott
PLATYV	plateau
PLAYR	plyler
PLC	plache
PLHAM	pelham
PLKCYA	pellecchia
PLKY	pelkie
PLNKNR	plencner
PLNTH	plante
PLTAYR	pelletier
PLTCR	pletcher
PLTFRM	platform
PLTKVS	platkus
PLTNN	peltonen
PLT	pelt
PLT	plat
PLTYV	plateau
PLTYYR	pelletier
PLVHN	ploehn
PLVMR	plummer
PLYGRYNY	pelligrini
PLYNSKYN	plinskin
PLYSKYN	pliskin
PLYT	plate
PLYV	palaio
PNBAKR	pennebaker
PNDLTN	pendleton
PNDLTVN	pendleton
PNDYA	pandya
PNGADV	pengadu
PNG	peng
PNKRAS	pancras
PNL	pennell
PN	pan
PNS	pence
PNTVN	panton
PNYMAN	penniman
PNYNSVLA	peninsula
PNYNZVLA	peninsula
PNY	penny
PPH	pepe
PPLR	peppler
PPYN	pepin
PRABST	probst
PRACT	pratchett
PRADV	prado
PRAGV	prague
PRAHL	prahl
PRAKTYKVM	praktikum
PRAL	prall
PRALT	perrault
PRAM	pram
PRAMVD	pramod
PRANAV	pranav
PRANGS	prongs
PRANK	pranke
PRAPYS	prupis
PRASAD	prasad
PRASANA	prasana
PRASANT	prashant
PRASN	prasen
PRAS	prush
PRATP	pratap
PRAT	pratt
PRATS	prates
PRATVL	pratul
PRATYK	prateek
PRATYKS	pratiksh
PRATYKV	prattico
PRAVL	prowell
PRAVYN	praveen
PRAYB	pribe
PRAYL	prael
PRAYM	prime
PRAYVN	priven
PRAYVYT	private
PRBN	preben
PRC	prech
PRDYKARV	perdicaro
PRDYKYS	perdikis
PRDYS	paradise
PRKAS	pereckas
PRKS	parks
PRKYNS	perkins
PRKYNZ	perkins
PRLMAN	perlman
PRLMN	perlman
PRL	perel
PRLR	perler
PRLY	perley
PRMAL	premal
PRNT	parent
PRNTYS	prentiss
PRPK	perpk
PRSATTAM	purshottam
PRSKAT	prescott
PRSL	pursell
PRSLT	prechelt
PRSTN	preston
PRSTRVD	prestrud
PRSTRV	prestero
PRSTVN	preston
PRSVN	persson
PRSYNV	porcino
PRSYVAL	percival
PRVAMR	pruemmer
PRVAN	provan
PRVGTV	progetto
PRVJT	projet
PRVMVNTVRY	promontory
PRVN	parrone
PRVPS	propes
PRVS	pruss
PRVTRV	prothero
PRVTVS	protus
PRVV	provo
PRVVST	provost
PRVYN	parvin
PRVY	pruy
PRVYS	purvis
PRYA	priya
PRYAVLT	perreault
PRYBL	preble
PRYCARD	pritchard
PRYDY	preedy
PRYKLY	prickly
PRYKN	perricone
PRYKT	prickett
PRYLV	perillo
PRYMRV	primero
PRYMV	primeau
PRYMYVS	primus
PRYNG	pering
PRYN	perrin
PRYNS	prince
PRYNSS	prentiss
PRYNT	pariente
PRYNY	perini
PRY	perry
PRYSKAT	prescott
PRYSLR	preisler
PRYSTLY	priestley
PRYSTLY	priestly
PRYST	priest
PRYSTVN	preston
PRYSYLA	priscilla
PRYSYNG	pricing
PRYTCARD	pritchard
PRYTY	preeti
PRYTY	pretty
PRYTZ	pritz
PRYVR	pryor
PRYVS	preuss
PRYVST	prevost
PRYYVTY	priotti
PRZ	perez
PSKYN	peskin
PSNKV	pecenko
PS	pass
PSTMA	postma
PST	post
PTCR	petcher
PTKR	patkar
PTLA	patella
PTRN	petren
PTR	peter
PTRSN	paterson
PTRSN	patterson
PTRSVN	paterson
PTRSVN	patterson
PTRVF	petrov
PTRVNLA	petronella
PTRV	petro
PTRVV	petrov
PTRVYC	petrovich
PTRYC	petrich
PTRYK	patrick
PTRY	petry
PTRZ	peters
PTSY	patsy
PTV	petto
PTYBN	pettibone
PTYBVN	pettibone
PTYL	pathyil
PTYNS	patience
PTY	pati
PTY	patti
PTY	patty
PTYTJYN	petitjean
PTZVLD	petzold
PVALMA	puelma
PVA	puah
PVGA	puga
PVGLYS	pugliese
PVG	pugh
PVGVSYAN	pogosyan
PVHAN	puhan
PVHAR	pohar
PVHL	pohl
PVH	poh
PVKVRNY	pokorny
PVLAKVS	poulakos
PVLGAR	pulgar
PVLK	polk
PVLMYTYS	polemitis
PVLND	poland
PVLN	polen
PVLN	pollen
PVLNT	polant
PVL	pool
PVL	powles
PVLSN	polson
PVLS	poulos
PVLS	powles
PVLTR	poulter
PVLV	polo
PVLVVYN	polowin
PVLYNG	poling
PVLYPALY	polepalli
PVLY	pulley
PVLYS	polis
PVLYT	politte
PVLYYAM	pulliam
PVLZ	powles
PVMA	puma
PVMFRY	pumfrey
PVNA	puna
PVNT	point
PVNVZ	punnoose
PVPAT	popat
PV	pouw
PVP	pope
PVP	popp
PVRAHV	purahoo
PVRANYK	puranik
PVRJZ	porges
PVRKV	porco
PVR	poore
PVRTNVY	portnoy
PVRTRFYLD	porterfield
PVRVS	proos
PVRYNTVN	purinton
PVRYR	puryear
PVSALA	poosala
PVSARY	puusaari
PVSN	posen
PVS	posh
PVSTYL	postill
PVSV	poso
PVSY	pusey
PVTKVNN	putkonen
PVT	poot
PVTRY	poutre
PVTYT	petit
PVTYT	petite
PVTZ	putz
PVVLZ	powles
PVV	pouw
PVYNT	point
PVYNTYNG	poynting
PVYRYR	poirier
PVYSL	poisl
PVYV	pouw
PVZYVS	posius
PYAK	paik
PYATJY	pietje
PYATK	piatek
PYBADY	peabody
PYDH	peade
PYD	peade
PYD	peed
PYJH	pietje
PYJT	pagett
PYKAP	pickup
PYKARD	pickard
PYKASV	picasso
PYKL	pickel
PYK	paik
PYK	peak
PYK	pieck
PYK	pike
PYKRL	pickrell
PYKS	peaks
PYKVLBNY	piccolboni
PYKZ	peaks
PYLAR	pillar
PYLARZ	pillars
PYLATV	pilato
PYLAZV	peloso
PYL	peil
PYL	pil
PYLVSKY	pilewski
PYLVYV	pilvio
PYLY	pillay
PYLYSNRY	pillsbury
PYNAKL	pinnacle
PYNA	pina
PYNCAZ	pinchas
PYNCRA	pinchera
PYNDAR	pindar
PYNDV	pinedo
PYNGNVT	pingenot
PYNG	ping
PYNKVVYTZ	pinkowitz
PYNKY	pinky
PYN	pane
PYN	payne
PYN	pinn
PYNSN	pinson
PYNSVN	pinson
PYNTH	pinette
PYNTN	paynton
PYNTR	painter
PYNTR	paynter
PYNTR	pinter
PYNTVN	paynton
PYNTVN	pinton
PYNV	pinnow
PYNV	pino
PYNXAM	pinkham
PYNYAN	pinyan
PYNY	paiani
PYNZ	pins
PYPGRAS	pipgras
PYP	pape
PYP	peipp
PYPR	pieper
PYPVNY	piponi
PYRAMYD	pyramid
PYRAN	piran
PYRANY	pirani
PYRARD	pirard
PYRAVAT	pirawat
PYRKV	pirkko
PYRLMAN	pearlman
PYRL	pearl
PYRMN	pearman
PYR	pier
PYRSN	pearsen
PYRSN	pearson
PYRSN	pierson
PYRS	pearce
PYRS	piers
PYRSVN	pearson
PYRT	peart
PYRV	piero
PYRVZ	piroz
PYRY	pirih
PYRYR	poirier
PYRYZ	perez
PYRZ	perez
PYSAH	peasah
PYSAN	paysan
PYSH	piche
PYSLY	paisley
PYSNS	patience
PYS	pace
PYS	pais
PYS	pease
PYSTVN	pistun
PYTAN	pitman
PYTA	pitha
PYTH	pietje
PYTJ	pietje
PYTKV	pitkow
PYTMN	pittman
PYT	payette
PYT	peat
PYT	peet
PYT	pietje
PYTR	peter
PYTR	peters
PYTR	pieter
PYTRSVN	petersson
PYTRV	petrow
PYTRZ	peters
PYTS	pitts
PYTYBVN	pettibone
PYVMLY	piomelli
PYVN	pion
PYVNYK	pivnick
PYV	pugh
PYVRYNTN	purinton
PYVTR	piotr
PYYK	peak
PYYRY	pieri
PYYV	pui
PYZA	pizza
PYZLY	paisley
PYZS	paizis
PYZVLYTV	pizolato
PYZYALY	piziali
PYZYNY	pizzini
PYZY	pizzi
PYZYR	pyziur
PZARAYS	pezaris
QADSYH	qadisiyah
QALYA	ghaliya
QASAN	ghassan
QASM	qasim
QAYD	ghayth
QAYS	ghayth
QBYLH	qubilah
QDAMH	qudamah
QDYLA	galila
QDYL	gadil
QDYM	qadir
QDYRA	qadira
QDYR	qadir
QDYSH	qadisiyah
QDYSYHA	qadisiyah
QLYA	ghaliya
QLYBA	ghaliya
QLYB	ghalib
QLYLA	galila
QML	gamal
QMR	qamar
QNTVN	ginton
QRBYA	gharbiyah
QRYBYH	gharbiyah
QSAN	ghassan
QSN	ghassan
QSYM	qasim
QSYM	quasim
QTRAN	ghufran
QVASYM	quasim
QVBYLH	qubilah
'QYLA	akilah
'QYLA	aqila
'QYL	akil
'QYL	aqil
QYT	ghayth
QYVN	givon
RABKYN	rabkin
RABLD	rabold
RABL	rabel
RABNAV	rabenau
RABN	raben
RABN	ruben
RAB	robb
RABRT	robert
RABRTSN	robertson
RABRTSVN	robertson
RAB	rubb
RABTM	rubottom
RABVYL	raboel
RABYDYAKS	robideaux
RABY'H	rabiah
RABYJN	robijn
RABYN	robbin
RABYN	rubin
RABYNSN	robinson
RABYNSVN	robinson
RABY	robby
RABY	robey
RABYV	rubio
RACL	rachael
RAC	rouch
RADAK	radek
RADBRG	rodberg
RADBVD	radboud
RADBVN	radbone
RADHA	radha
RADHYKA	radhika
RADKLYF	radcliff
RADK	radek
RADMN	rodman
RADNBRC	radenburch
RADNBRGARBRVK	radenburgerabroek
RADNBRGRABRK	radenburgerabroek
RADNBRGRABRVK	radenburgerabroek
RADNBRGRBRVK	radenburgerabroek
RADNYK	rudnick
RAD	rad
RADRAMVNY	rudramuni
RADRFRD	rutherford
RADR	rader
RADR	roder
RADT	ruudt
RADVA	radwa
RADVF	radov
RADVLFS	rudolphus
RADVLFVS	rudolphus
RADV	radu
RADVYG	rudewig
RADYAH	radeyah
RADYH	radeyah
RADYNG	radig
RADY	ruddy
RAFALKV	rafalko
RAFAL	rafal
RAFALSKY	rafalski
RAFA	rafa
RAFAYL	rafael
RAFAYLY	rafaeli
RAFNR	ruffner
RAF	roff
RAFRTY	rafferty
RAFYKYV	rafique
RAFYL	rafael
RAFYN	raffin
RAFY	rafi
RAGATZ	ragatz
RAGLND	ragland
RAGL	ragle
RAGNAR	ragnar
RAGNARSVN	ragnarsson
RAGNRD	rognerud
RAGNVALD	ragnvald
RAGRV	rogero
RAGSDYL	ragsdale
RAHARJV	rahardjo
RAHBK	rohbeck
RAHRR	rohrer
RAHRYG	roehrig
RAHVL	rahul
RAHY	rahi
RAJCR	rajcher
RAJNDR	rajender
RAJN	radjen
RAJ	raj
RAJR	rogers
RAJRZ	rogers
RAJS	rojas
RAJV	raju
RAJYV	rajeev
RAKAH	raqqah
RAKL	rockel
RAKL	ruckle
RAK	roch
RAKVN	rukan
RAKV	racho
RAKYKVT	racicot
RALF	ralf
RALF	ralph
RALF	rolfe
RAMA	rama
RAMBL	rumble
RAMBV	rambo
RAMPLZ	rumples
RAM	ram
RAM	ramm
RAMR	ramer
RAMS	ramesh
RAMSY	ramsey
RAMSYR	ramseier
RAMTAN	ramthun
RAMVLVS	romulus
RAMVS	ramos
RAMY	rami
RAMYRV	ramiro
RAMZ	ramez
RANA	rana
RANDL	rundle
RANDR	rander
RANGL	rongel
RANKYN	ronkin
RANN	ronnen
RAN	rohn
RAN	ron
RAN	ronne
RANR	runner
RANTGN	rontgen
RANY	ronni
RANY	ronnie
RANY	rony
RANYV	ranu
RAPBRYK	ropebrake
RAP	krupp
RAPR	roper
RARK	rourke
RASA	rasha
RASCN	kruschen
RASDAL	ragsdale
RASD	rashed
RASFVRD	rushforth
RASKH	raschke
RASK	rusk
RASKYN	raskin
RASL	rachel
RASL	russell
RASMN	rossman
RASNDAL	rosendale
RASNDYL	rosendale
RASNMAN	rosenman
RASPYNY	ruspini
RAS	rath
RAS	ross
RAS	russ
RAS	ruth
RASTN	roston
RASTRAM	rostrom
RAST	rust
RASTYN	rastin
RASTY	rusty
RASVM	rossum
RASV	raso
RASV	rasu
RASV	russo
RASYD	rashid
RATCSVN	ratcheson
RATGRT	rutgert
RATJRT	rutgert
RATKS	rutks
RATMN	rathmann
RATRA	rothera
RAT	rath
RATRFVRD	rutherford
RAT	ruth
RATSTRVM	ruthstrom
RAVBATM	rowbottom
RAVDAH	rawdah
RAVDA	radwa
RAVDA	rawdah
RAVLND	rowland
RAVLT	raoult
RAVNR	rovner
RAV	rao
RAV	rau
RAV	rauh
RAVRDY	raverdy
RAV	rov
RAVRT	roworth
RAVS	rouse
RAVT	rout
RAVYAH	rawiyah
RAVYH	rawiyah
RAVYNDRAN	ravindran
RAVYRAJ	raviraj
RAVY	ravey
RAVY	ravi
RAYBLT	rybolt
RAYDAH	raidah
RAYDJ	ridge
RAYDL	riedel
RAYDN	ryden
RAYFL	riffle
RAYLH	rayle
RAYLY	raile
RAYMVND	raymond
RAYNR	rayner
RAYP	riepe
RAY	rai
RAYSL	risel
RAYS	royce
RAYSTLYN	raistlin
RAYT	wright
RAYTZ	rights
RAYVARD	rivard
RAYVLYNGZ	rawlings
RAYV	rao
RAYVTYALA	rautiala
RAYZL	raizel
RAZDAN	razdan
RAZN	rossen
RAZVRBK	razorback
RBHVLZ	rebholz
RBRTSVN	robertson
RBVK	roebuck
RBVSV	reboso
RBYAH	rabiah
RBYH	rabiah
'RBYL	arbil
RBYS	rbeis
RDAH	rawdah
RDA	rawdah
RDBVN	radbone
RDFYLD	redfield
RDLFVS	rudolphus
RDLVS	redlus
RDMN	redman
RDMYL	redmill
RDRYK	roderick
RDVA	radwa
RDVLF	rudolph
RDVNDV	redondo
RDYDH	raidah
RDYH	radeyah
RDY	reddy
RFA	rafa
RFSNS	refsnes
RFSVN	refson
RF'T	rafat
RGD	raghd
RGV	rego
RHLYNG	rehling
RHNY	rheni
RHYMAH	rahimah
RHYMH	rahimah
RHYM	rahim
RJAS	rajas
RJAT	rajat
RJ	reg
RKAH	raqqah
RKDAL	reckdahl
RKKAH	raqqah
RKSTN	reksten
RKVG	reckeweg
RLF	rolfe
RLYVS	krelius
RLYVZ	krelius
RMD	remde
RMFR	rempfer
RMLYNGR	remlinger
RMNCYK	romanchik
RMN	remmen
RMNS	romans
RMPLYNG	rampling
RMVNY	rimoni
RMY	remy
RNALDZ	renalds
RNALT	renault
R'NA	rana
RNA	rana
RNAVD	renaud
RNBART	rennebarth
RNDHL	randhol
RNDR	rendar
RNDY	randy
RNJ	rheni
RNVYS	renvoise
RN	wren
RNY	rheni
RNZLND	renzland
RNZ	renze
RPLAGL	replogle
RPRT	reppert
RPTVN	repton
RQAH	raqqah
RQA	raqqah
RQD	raghd
'RRYFA	arrifa
RSA	rasha
RSL	rechelle
RSL	resele
RSNYK	resnick
RST	rest
RSVL	rasul
RSVLVYRT	resolveert
RSVNAT	resonate
RSVNDL	rosendale
RSYDA	rashida
RSYDH	rashida
RSYD	rashida
RSYNH	resyntje
RSYNJH	resyntje
RSYNTH	resyntje
RSYNTJ	resyntje
RSYVYN	krisoijn
RTKLYF	ratcliffe
RT	rat
RVAN	rowan
RVATR	rueter
RVAY	ruey
RVAYZ	ruiz
RVAZNR	roesner
RVBRJ	roberge
RVBR	roeber
RVBRTA	roberta
RVBRT	robert
RVBRTSVN	robertson
RVBRTV	roberto
RVBVZ	roboz
RVBYN	rubin
RVBYNSVN	robinson
RVBYNZ	robbins
RVBY	roby
RVBY	rubie
RVC	roach
RVC	roche
RVDA	rawdah
RVDH	rawdah
RVDLV	rudloe
RVDNBRG	roodenburg
RVD	rohde
RVD	rood
RVDRYGV	rodrigue
RVDRYGZ	rodriguez
RVDVLFAS	rudolphus
RVDVLF	rudolph
RVDVLFVS	rudolphus
RVGALSKY	rogalsky
RVGVZA	rogoza
RVHAN	rohan
RVHL	ruholl
RVHM	rohm
RVHN	rohn
RVHRR	rohrer
RVHR	ruehr
RVJAS	rojas
RVKAN	rukan
RVKA	rocca
RVKN	rukan
RVKRY	rookery
RVKSAN	roxanne
RVKSAN	roxsan
RVKV	roscoe
RVKYKY	rokicki
RVKZ	rooks
RVLAND	rowland
RVLDAN	roldan
RVLFH	rolfe
RVLF	rolfe
RVLF	rolff
RVLND	rowland
RVLS	rowles
RVLV	revelo
RVLY	rowley
RVMFVRT	roumfort
RVMRV	romero
RVMYG	romig
RVMYV	romero
RVNALD	ronald
RVNDA	ronda
RVNDH	ronde
RVNDL	roundel
RVNDYN	rondane
RVNGV	rongo
RVNTRY	rountree
RVNY	roni
RVNY	rooney
RVNYT	ronit
RVPKH	roepke
RVPRT	rupert
RVP	rupe
RVRKH	rourke
RV	roa
RV	roe
RVR	roar
RV	rue
RVRY	rory
RVRYS	treuerice
RVSALYN	rosalyn
RVSAM	rosham
RVSAM	rowsome
RVSANA	rosana
RVSA	rosa
RVSKV	roscoe
RVSL	russell
RVSLYN	roslyn
RVSLYN	rosselin
RVSNAL	rosendale
RVSNBLAT	rosenblatt
RVSNDAL	rosendale
RVSNDL	rosendale
RVSNFLD	rosenfeld
RVSN	rosen
RVSNR	rossner
RVS	ross
RVS	rouse
RVS	roush
RVSR	rosser
RVSTAD	rostad
RVSTND	rostand
RVSVLT	roosevelt
RVSVN	rosson
RVSV	rosu
RVSV	russo
RVSYALA	rotiala
RVSYTR	rossiter
RVTABAGA	rutabaga
RVTGR	rutgert
RVTGRT	rutgert
RVTJ	vrouwtje
RVTJY	vrouwtje
RVTRFRD	rutherford
RVT	roath
RVT	root
RVT	rothe
RVT	route
RVT	rowett
RVT	ruth
RVT	ruudt
RVTS	rootes
RVTZ	rotz
RVVLVRY	revuluri
RVVTH	vrouwtje
RVVT	ruudt
RVVT	vrouwtje
RVYAH	rawiyah
RVYAL	royal
RVYAPA	royappa
RVYBL	ruebel
RVYDN	rueden
RVYH	rawiyah
RVYL	royle
RVYLY	rowley
RVYMATA	roimata
RVYN	rooyen
RVYN	rouen
RVYPK	roepcke
RVY	roy
RVYS	royce
RVYS	royse
RVYS	ruiz
RVYTNBRG	roytenberg
RVYYZ	ruiz
RVYZ	ruiz
RVZMARY	rosemarie
RVZMARY	rosemary
RVZNDAL	rosendale
RVZNFLDR	rosenfelder
RVZNJK	rosenjack
RVZN	rosen
RVZ	rouse
RVZ	roze
RVZ	ruiz
RVZVLT	roosevelt
RVZY	rosie
RVZYR	rosaire
RVZYR	rozier
RVZYTA	rosita
RYAD	riyad
RYBAK	roebuck
RYBAR	ribar
RYBK	reback
RYB	rieb
RYBRN	rayburn
RYCARD	pritchard
RYCARDSN	richardson
RYCARDSVN	richardson
RYCAR	richar
RYCAV	richau
RYCMN	richmann
RYCMYR	richmeyer
RYC	rich
RYCR	richer
RYCY	richey
RYCY	ritchie
RYDA	raidah
RYDA	rida
RYDA	riyad
RYDH	raidah
RYDH	rida
RYDJ	ridge
RYDKVYST	rydquist
RYDL	riddle
RYDNBRC	radenburch
RYDNBRGYRBRAK	radenburgerabroek
RYDN	reyden
RYD	reed
RYDR	ryder
RYDYG	reodique
RYDY	reidy
RYFKAYND	rifkind
RYGAN	ragan
RYGARD	regard
RYGLR	rigler
RYG	ridge
RYGV	rigo
RYGYNZ	riggins
RYHANA	rihana
RYHANH	rihana
RYHL	riehle
RYJKARD	rijkaard
RYJ	ridge
RYJSVYJK	rijswijk
RYJSVYK	rijswijk
RYJYNZ	riggins
RYKARD	rickard
RYKARD	rijkaard
RYKR	ricker
RYKRT	rickert
RYKSVN	rixon
RYKTZ	ricketts
RYKVLSVN	richolson
RYKY	ricky
RYLND	reiland
RYL	riel
RYLSBK	railsback
RYLY	reilley
RYMANT	reymont
RYMND	raymond
RYMNZ	riemens
RYM	rim
RYMRS	riemers
RYMVND	raimond
RYMVND	raimund
RYMVND	raymond
RYMVN	rymon
RYMYL	rymill
RYMY	reamy
RYNAH	zaynah
RYNALDA	reenalda
RYNALD	rainald
RYNALDS	reynolds
RYNALDZ	reynolds
RYNDNR	rindner
RYNDRT	reindert
RYNDRZ	reinders
RYNG	ring
RYNGST	ringuest
RYNGVVD	ringwood
RYNH	rinne
RYNKR	rinker
RYNLDA	reinolda
RYN	rane
RYN	rinn
RYNR	rainer
RYNR	ribner
RYNRT	reinert
RYNTVL	rintoul
RYNVD	reinoud
RYNVLDA	reinolda
RYNVLD	reinold
RYNVLD	reinoud
RYNVLDS	reynolds
RYNVLDSVN	reynoldson
RYNVLDZ	reynolds
RYNVVD	reinoud
RYPL	rippel
RY	ray
RYRDAN	reardon
RYRDAN	riordon
RYRDN	reardon
RY	rey
RYRSVN	reierson
RYRZ	rears
RYSAH	rishah
RYSALVYRT	resolveert
RYSAR	rischar
RYSAVY	rysavy
RYSJY	krisje
RYSKAR	racecar
RYSLVRT	resolveert
RYSLYNG	rysling
RYSLY	risley
RYSNR	reisner
RYSNR	reissner
RYSNYK	resnick
RYSRC	research
RYS	reese
RYS	reiss
RYS	reyes
RYS	ries
RYS	riese
RYSR	raicer
RYSR	reaser
RYSTV	risto
RYSTYNTJY	kristijntje
RYSTY	raisty
RYSVLVRT	resolveert
RYSVLVVRT	resolveert
RYSVR	reasor
RYSVYK	rijswijk
RYSY	reese
RYTAKV	ritacco
RYTA	rita
RYTCY	ritchie
RYT	raith
RYTSGRT	ritsgert
RYTVGR	rittweger
RYTYSGRT	ritsgert
RYTZGRT	ritsgert
RYTZ	reetz
RYTZR	retzer
RYVARD	rivard
RYVBR	reuber
RYVDT	ruudt
RYVMLR	ruemmler
RYVNSVN	runeson
RYVNVLD	reinoud
RYVPKA	riopka
RYVR	river
RYV	ryu
RYVRZ	rivers
RYVV	raivo
RYVYRH	rivoire
RYVYS	reavis
RYYAD	riyad
RYYD	reed
RYYNKS	rienks
RYYR	rayer
RYZ	reese
RYZR	reiser
RYZVLVRT	resolveert
RYZV	rizzo
RYZVY	rizvi
RZBRY	roseberry
RZNBAVM	rosenbaum
RZNFLD	rosenfeld
RZNKRANS	rosencrans
RZNLF	rosenlof
RZNMN	rosenman
RZNTJY	resyntje
RZVLVRT	resolveert
RZYNT	resyntje
SAARTJ	saartje
SABGLASYAL	subglacial
SABHANY	subhani
SABLT	sublette
SABRAMANYAM	subramaniam
SABRAMANYAN	subramanian
SAB	shub
SABTNS	subtense
SABT	sabot
SABVRYN	sabourin
SABVS	schabus
SABYN	sabine
SABYNY	sabini
SACAT	shachat
SACK	sawchuk
SACR	suture
SADGRV	sadgrove
SADHA	shadha
SADLR	sadler
SADRBLAM	soderblom
SADYAH	shadiyah
SADYH	shadiyah
SADYK	saddique
SADYKV	saddique
SADYKVYH	saddique
SADYKYV	saddique
SADYVP	sudupe
SAFR	schafer
SAF	shuff
SAFT	soft
SAFTVR	software
SAFTYN	safoutin
SAGARS	sugars
SAGA	suga
SAGAYY	sugai
SAGN	schagen
SAGRV	sadgrove
SAGRV	shugrue
SAHASY	sahasi
SAH	shuh
SAHVLM	shuholm
SAJN	schagen
SAJRV	sadgrove
SAKAMVTV	sakamoto
SAKARY	sakari
SAKAYV	sakaue
SAKLAD	saklad
SAKLA	shukla
SAKSNA	saxena
SAKSNM	saxnem
SAKS	sacks
SAKS	saxe
SAKSVN	saxon
SAKSYM	saxnem
SAKTN	sackton
SAKT	sackett
SAKYA	shakya
SAKY	shockey
SALGA	shulga
SALGVRV	salgueiro
SALKRAS	shallcross
SALK	solak
SALMVND	salmond
SALMY	salmi
SALTZMN	saltzman
SALTZ	shultz
SALVMN	solomon
SALVM	shalom
SALVMVN	solomon
SALYAN	salian
SALYGRAM	shaligram
SALYN	salanne
SALY	sully
SALYT	shalette
SALYVAN	sullivan
SALZBRG	salzberg
SALZNBRG	salzenberg
SAMADAR	samaddar
SAMAH	samah
SAMAKR	shumaker
SAMAN	samman
SAMANTA	sumanta
SAMANTA	sumanth
SAMAR	shammar
SAMAS	shamas
SAMBAT	shambat
SAMBVLYK	sambolec
SAMGYN	sumgin
SAMH	sameh
SAMK	samec
SAML	samel
SAMN	solomon
SAMRAL	sumrall
SAMR	sameer
SAMR	sammer
SAMRZ	summers
SAM	shum
SAMS	somesh
SAMTYNG	something
SAMVLS	samuels
SAMVN	sumon
SAMVSKY	samosky
SAMVYL	samuel
SAMYR	shamir
SAMYT	sumit
SAMYT	summit
SAMZ	sams
SANAHAN	shanahan
SANANDV	sunando
SANA	sana
SANBRN	sansburn
SANCTY	sancheti
SANDAR	sundar
SANDHV	sandhu
SANDLYN	sundelin
SANDMAN	sandman
SANDRAM	sundaram
SANDRM	sundaram
SANDRNZ	saunders
SANDRS	saunders
SANDRSVN	sanderson
SANDRZ	sanders
SANDRZ	saunders
SAND	sand
SANDYP	sundeep
SANDY	sunday
SANGLD	sungold
SANG	sang
SANG	sung
SANGV	sangho
SANJAY	sanjay
SANJH	santje
SANJSTR	sangster
SANKAR	shankar
SANKN	sunken
SANKR	shanker
SANKR	sunker
SANK	shank
SANK	sunk
SANLA	sannella
SANLY	sunley
SANNAR	shunnar
SANRANG	sunrong
SANRAYZ	sunrise
SANRJH	sannertje
SANRTH	sannertje
SANRTJY	sannertje
SANRT	sannertje
SANSAYN	sunshine
SANSBRN	sansburn
SAN	shan
SAN	son
SANSS	sancese
SANST	sunset
SANSVN	shanson
SANTANA	santanna
SANTA	santa
SANTH	santje
SANTJ	santje
SANTJY	santje
SANTRTJ	sannertje
SANT	santje
SANTSBRN	sansburn
SANTV	santo
SANTVS	santos
SANTVSY	santucci
SANTYK	santic
SANTY	santee
SANVNDV	sunondo
SANVN	shannon
SANV	sanov
SANYL	sunil
SANY	sunni
SANY	sunny
SANYT	suneet
SANZBVRN	sansburn
SANZ	sanz
SAPRV	shapero
SAP	sup
SARANN	saranen
SARA	thara
SARATY	sarathy
SARDGNA	sardegna
SARDLV	shardlow
SARDV	sardo
SARJH	saartje
SARKNAS	sharknas
SARLVT	charlotte
SARLY	sharlee
SARMA	sarma
SARNA	sarna
SAR	sahr
SAR	shar
SARTAKSV	cartaxo
SARTH	saartje
SARTJ	saartje
SARTJY	saartje
SART	saartje
SART	sarrett
SARTZR	shartzer
SARVATH	sarwate
SARVK	sharock
SARY	shari
SARYVL	sauriol
SASAKY	cacace
SASAN	sawsan
SASKA	suska
SASLAV	saslav
SASMN	sussman
SASNHYM	sassenheim
SASN	shushen
SASTK	shostack
SASTYK	sustik
SASZH	sasze
SASZ	sasze
SASZY	sasze
SATFN	sutphen
SATFYN	sutphen
SATJ	celetje
SATKAS	sutkus
SATN	sutton
SATR	sather
SATR	suter
SAT	schut
SAT	shutt
SATVN	shotton
SATVN	sutton
SATVR	satur
SATV	saito
SAVAN	sawan
SAVARAM	savaram
SAVARS	savarese
SAVCVK	sawchuk
SAVDY	sawdey
SAVFRD	sawford
SAVL	saul
SAVL	savel
SAVL	shaul
SAVLZ	sauls
SAVNDRZ	saunders
SAVSAN	sawsan
SAV	shaw
SAVTR	sauter
SAVTR	sauther
SAVTZ	savetz
SAVVY	savoy
SAVYN	savin
SAVYR	sauer
SAYBRMYJ	cybermage
SAYBRT	siebert
SAYDA	saida
SAYKS	sikes
SAYKV	psyko
SAYLR	schuyler
SAYMKV	simko
SAYM	syme
SAYMVN	simon
SAYMVNS	simons
SAYP	sipe
SAYRY	sayre
SAYTJ	sytje
SAYT	sytje
SAYTV	saito
SAYTZ	sites
SAYVRYNGLNT	siuuirdingelant
SAYVYRDYNGLANT	siuuirdingelant
SAYVYR	sawyer
SAZH	sasze
SBASTYN	sebastiaen
SBASTYN	sebastian
SBAYN	sabine
SBHAN	sobhan
SBRA	sabra
SBRT	shebert
SBRYANY	sebrianne
SBRY	sebree
SBS	shebs
SBYRAH	sabirah
SBYRA	sabirah
SBYRH	sabirah
SBYSTN	sabiston
SBYT	thabit
SDAH	sadah
SDAH	shadha
SDA	seda
SDAY	sedai
SDGRV	sadgrove
SDHA	shadha
SDH	sadah
SDLR	sadler
SDRHLM	cederholm
SDRVV	sadgrove
SD	sed
SDS	seds
SDVAL	sedvall
SDVR	sedore
SDV	shadow
SDYA	shadiyah
SDYH	shadiyah
SDYK	saddique
SDYRA	sadira
SFARD	shephard
SFRD	shepherd
SF	shef
SFYLD	sheffield
SGAL	segal
SGVRA	segura
SHA	shadha
SHRAB	sohrab
SHR	sehr
SH	seh
SHYB	sahib
SKANL	scannell
SKARP	scarp
SKAR	shekar
SKLANY	saklani
SKMAN	sheckman
SKRNTN	scranton
SKSNM	saxnem
SKSPYR	shakespeare
SKSTN	sexton
SKSTVN	sexton
SKT	sackett
SKVYRA	sequeira
SKYVRYTY	security
SLAMKY	slumkey
SLAMN	solomon
SLAR	slater
SLARYR	celarier
SLAT	slut
SLAY	sly
SLAYZ	shlaes
SLBRG	selberg
SLBRG	solberg
SLDN	sheldon
SLDVN	sheldon
SLF	shelf
SLFY	salfi
SLJ	celetje
SLJ	sledge
SLK	selleck
SLMA	salma
SLMA	selma
SLMYDY	shelmidi
SLMY	salma
SLNY	slaney
SLR	sheller
SL	sell
SL	shel
SLT	celetje
SLTH	celetje
SLTJH	celetje
SLTVN	shelton
SLVA	salwa
SLVD	selwood
SLVDVF	solodov
SLVN	sloan
SLVN	sloane
SLVVD	selwood
SLYJ	celetje
SLYMANYH	sulaymaniyah
SLYMA	selima
SLYMH	selima
SLYM	selim
SLYM	slim
SLYNA	selima
SLYPRY	slippery
SLY	shelly
SLYTR	slater
SLYV	celio
SMAH	samah
SMAL	cemal
SMALYAH	shamaliyah
SMALYH	shamaliyah
'SMAN	othman
SMAR	samar
SMAR	shammar
SMA	samah
SMA	samma
SMAT	shamat
SMBHV	shambhu
SMBLNKS	samblanx
SMH	sameh
SMKVVN	smakovane
SMLY	semele
SMMA	samma
SMMR	shammar
SMPL	sample
SMPT	sampath
SMRN	someren
SMR	samar
SMR	shammar
SM	sam
SMSC	simicich
SMSL	samsel
SMVTYVK	semotiuk
SMYAH	samiyah
SMYH	samiyah
SMYLH	shamaliyah
SMYM	shamim
SMYRAH	samirah
SMYRA	samira
SMYRA	samirah
SMYRH	samirah
SMYR	sameer
SMYR	schmeer
SMYR	semir
SMYS	shamis
SMYTLY	smitley
SMYZ	semiz
SNAN	shenan
SNA	sana
SNA	sena
SNA	thana
SNDBRG	sandberg
SNDFVRD	sandford
SNDHYL	sendhil
SNDLYN	sandlin
SNDMN	sandman
SNDRS	sanders
SNDRZ	sanders
SND	sand
SNDS	sands
SNDVYK	sandvik
SNDY	sandie
SNDZ	sands
SNFNG	shenfeng
SNFTLYBN	senftleben
SNGAL	sangal
SNGLVGLV	cengeloglu
SNG	sang
SNG	seng
SNG	sheng
SNGVPTA	sengupta
SNGVTA	sengupta
SNHAL	snehal
SNJH	santje
SNKYAT	shenkiat
SNNRTJ	sannertje
SNNY	seeney
SNQAN	shenghun
SNR	senner
SNSBRN	sansburn
SN	shen
SNTJ	santje
SNT	saint
SNTYAGV	santiago
SNVRY	snorri
SNVTV	snotoa
SNYRJH	sannertje
SPARD	sheppard
SPARNDAM	spaarndam
SPASTYN	sebastiaen
SPHR	sepehr
SPRD	shephard
SPRYNGR	springer
SP	sheipe
SPYNVAL	sepinwall
SPY	seppy
SRAB	sarab
SRAFYN	serafin
SRASVL	cerasuolo
SRATVZA	serratosa
SRAYNH	shryne
SRCAK	serchuk
SRDAR	sardar
SRHYR	serhir
SRJH	saartje
SRKAMB	sircombe
SRKAN	sercan
SRK	shark
SRKS	sharks
SRKYAH	sharqiyah
SRKYH	sharqiyah
SRLD	thurlede
SRL	searle
SRLYNG	serling
SRLY	shirley
SRMAN	sherman
SRMN	sherman
SRPNT	serpent
SRQYH	sharqiyah
SRR	seurer
SRR	sherer
SR	serre
SR	sher
SR	sir
SRSTA	shrestha
'SRT	israt
SRTRYD	shortreed
SRVADY	servadei
SRVARY	sharvari
SRVMBC	crumbach
SRVVD	sherwood
SRVYC	scherwich
SRVYDYV	servideo
SRVYS	servis
SRVY	survey
SRYA	thurayya
SRYF	sharif
SRYF	sherriff
SRYNGTVN	sherrington
SRY	shari
SRY	sheri
SRY	sherry
SRYT	sharif
SRYVR	shriver
SSADRY	seshadri
SSANY	shoshani
SSDRY	seshadri
SSYL	cecil
STARLVZN	sturluson
STFANVS	stephanus
STHVRAJAN	sethurajan
STLAYN	shetline
STLND	shetland
STLR	shetler
STL	settle
STMF	stampf
STNT	steentje
STRATVN	straton
STRYTR	streater
ST	seth
STVFL	stoffel
STVRAMAN	sethuraman
STV	seto
STYVNSVN	stevenson
SVAFVRD	swafford
SVAGATV	swagato
SVAMY	swami
SVAMY	swamy
SVANK	swank
SVAN	shuen
SVAN	swan
SVANYK	sevanick
SVANY	sweeny
SVARMN	swearman
SVART	swart
SVARYNGYN	swearingin
SVAS	swash
SVA	swa
SVAYDA	suwayda
SVBHANDV	subhendu
SVBVTKA	sobotka
SVCAN	suchan
SVDAN	soudan
SVDAN	sudan
SVDARMV	sudarmo
SVDARSAN	sudarshan
SVDR	sowder
SVDYP	sudip
SVDYPTV	sudipto
SVDYR	sudare
SVDZ	shudes
SVFN	sutphen
SVFR	suffer
SVFYH	sophie
SVFYLD	schofield
SVFY	sophie
SVGN	sogen
SVGRLF	sugarloaf
SVG	swag
SVHA	soha
SVHAS	suhas
SVHA	suha
SVHM	sohm
SVKK	soucek
SVKLA	shukla
SVKVL	sokol
SVKVMAR	sukumar
SVLAR	solar
SVLAYMNYAH	sulaymaniyah
SVLDR	shoulder
SVLD	sold
SVLFVR	sulphur
SVLK	solek
SVL	sewell
SVL	sol
SVLTAN	sultan
SVLT	cholette
SVLTZ	scholtz
SVLVMVN	solomon
SVLV	solo
SVLVVY	solovay
SVLVYR	solovier
SVLVY	solvay
SVLY	soli
SVLYS	solis
SVLYTAS	sotilas
SVMA	soma
SVMASYKAR	somashekar
SVMJY	somjee
SVMN	soumen
SVMR	shomer
SVMRVYL	somerville
SVMVY	somvay
SVMYKR	shoemaker
SVNAR	shunnar
SVNA	suna
SVNDARAM	sundaram
SVNDRZ	saunders
SVNGKRN	songkran
SVNGR	songer
SVNGRVALA	songerwala
SVNG	sung
SVNJA	sonja
SVN	schon
SVN	seven
SVN	shoun
SVNSN	swensen
SVN	soun
SVNY	sonny
SVNY	sony
SVPN	sopan
SVPRATYK	supratic
SVPRYV	supriyo
SVP	shoup
SVRAB	sorab
SVRAB	sorabh
SVRAJ	suraj
SVRANA	surana
SVRK	sorc
SVRL	sorrel
SVRNSN	sorensen
SVRN	soren
SVR	sor
SVR	sore
SVRS	source
SVRSVN	severson
SVRTL	shortell
SVRTN	shorten
SVRVALY	sorvali
SVRYNDR	surinder
SVRYN	sorin
SVSAL	social
SVSA	susa
SV	schoo
SVSH	sousa
SV	shue
SVSN	sawsan
SV	soo
SV	sou
SV	sue
SVSYA	sucia
SVSYL	sushil
SVTAN	sutton
SVTFN	sutphen
SVTN	sutton
SVTR	suter
SVTR	sutter
SVTS	coutts
SVTV	soto
SVYAK	soyack
SVYDA	suwayda
SVYDH	suwayda
SVYFT	swift
SVYLR	schuyler
SVYLR	shuyler
SVYNGLR	swingler
SVYNRTVN	swinnerton
SVYN	savin
SVYN	swine
SVYR	sevier
SVYTNKY	switenky
SVYTV	suwito
SVYYNK	swink
SVZALYS	susalis
SVZANA	susanna
SVZANH	susanne
SVZA	souza
SVZ	suze
SVZV	sozo
SVZY	suzy
SYANDRA	sciandra
SYANG	shiang
SYANG	siang
SYANV	siano
SYBACR	seebacher
SYBL	seibel
SYBL	seibl
SYBLT	sebolt
SYBLY	sibley
SYBRT	siebert
SYDA	saida
S'YDH	saida
SYDLR	shidler
SYDLR	sidler
SYDMN	seedman
SYDNY	sydney
SYDR	seder
S'YD	said
SYD	seed
SYD	seid
SYDVR	sidor
S'YDY	saidi
SYFARD	shephard
SYGL	siegel
SYGL	siegl
SYGLTVN	singleton
SYGMN	sigman
SYGMN	sigmon
SYGMN	sijmen
SYGMVND	sigmund
SYG	sage
SYGS	siggs
SYHAN	sheehan
SYHN	sheehan
SYHSVBHVN	sihsobhon
SYHY	sheehy
SYJH	sytje
SYJKV	siejko
SYJMN	sijmen
SYKAGV	chicago
SYKAR	shiyekar
SYKARV	sekora
SYKR	shaker
SYK	sheik
SYKVLV	sicolo
SYKVRA	sikora
SYKY	siqi
SYLA	sela
SYLBRMAN	silbermann
SYLBRMN	silberman
SYLDN	sheldon
SYLDZ	shields
SYLK	silk
SYL	seil
SYLVAN	sylvan
SYLVA	silva
SYLVD	selwood
SYLVNN	silvonen
SYLVRBRG	silverberg
SYLVRMN	silverman
SYLVR	silver
SYLVRTVRN	silverthorne
SYLVRVD	silverwood
SYLV	silvo
SYLVVD	selwood
SYLVYA	silvia
SYLVYA	sylvia
SYLVY	silvey
SYLVYV	silvio
SYLYG	seelig
SYLYMAN	silliman
SYLYMN	silliman
SYLY	saley
SYLY	seely
SYLYT	celetje
SYLZMN	salsman
SYLZ	seales
SYLZ	seals
SYMAL	cemal
SYMARD	simard
SYMAYH	shimayah
SYMBAB	siembab
SYMLR	simler
SYMNDS	simmonds
SYMN	seaman
SYMN	seman
SYMN	siemon
SYMN	sijmen
SYMN	simen
SYMNZ	simmons
SYMPLYSYTY	simplicity
SYMR	simer
SYMR	simmer
SYMS	simms
SYMS	sims
SYMSYK	simcik
SYMVDYNZ	simodynes
SYMVNA	simona
SYMVNDS	simonds
SYMVNH	simone
SYMVNH	simonie
SYMVN	simon
SYMVN	simone
SYMVNSN	siemonsen
SYMVNS	simmons
SYMVNZ	simmons
SYMVNZ	simons
SYMYNG	siming
SYMYNGTVN	symington
SYMYN	shimin
SYMYN	simin
SYMZ	shames
SYMZ	simms
SYNA	cena
SYNAN	sinan
SYNA	seanna
SYNAYN	seanain
SYNDLMN	sindelman
SYNDRH	sindre
SYNGLTVN	singleton
SYNG	sing
SYNK	cinq
SYNKLARY	sinclair
SYNKLAYR	sinclair
SYNKLR	sinclair
SYNK	sync
SYNR	senner
SYN	sane
SYN	sean
SYN	shane
SYN	shein
SYN	sheyn
SYN	shin
SYN	sin
SYNTYA	cynthia
SYNV	seenu
SYNVY	shenoy
SYNYBALDY	sinibaldi
SYNYG	seanagh
SYNY	seeney
SYPL	seipel
SYPLVAYDN	schipluiden
SYPLVYDN	schipluiden
SYPLZ	sipples
SYPMN	shipman
SYPN	scheepen
SYPRYANV	sipriano
SYP	sheep
SYRAFYN	serafin
SYRAN	sheeran
SYRANT	sierant
SYRA	sierra
SYRAY	shirai
SYRCNT	searchnet
SYR	cyr
SYRKVYS	cirques
SYRL	searle
SYRLY	shirley
SYRR	shearer
SYR	sare
SYR	sayre
SYR	sheer
SYRS	serres
SYRS	sires
SYRVKA	sirucka
SYRVN	serrone
SYRVS	cyrus
SYRVYZ	sirois
SYRYF	sherriff
SYRYL	cyril
SYRYLV	cirilo
SYRYNG	siering
SYSABA	csaba
SY	sea
SY	see
SY	she
SY	shi
SYSK	sisk
SYSLVNZ	cyclones
SYSLV	sislo
SYS	seese
SYSTMZ	systems
SYSZ	simms
SYTARAM	sitaram
SYTA	sita
SYTAY	seytie
SYTH	seytie
SYTH	sytje
SYTJ	sytje
SYTJY	sytje
SYTLAYV	cittlau
SYTLR	sittler
SYTRAH	sitrah
SYTRA	sitrah
SYTRH	sitrah
SYT	seytie
SYT	sit
SYTS	sites
SYTV	seto
SYTYA	cetia
SYTYH	seytie
SYTY	seytie
SYTYZN	citizen
SYTZ	seitz
SYTZ	sheets
SYVALD	seewald
SYVALV	swallow
SYVA	siva
SYVAYRDYNGLNT	siuuirdingelant
SYVLA	savela
SYVL	sewell
SYVMN	coeyman
SYVNG	sung
SYVNKA	cionca
SYVN	sune
SYVNYS	theunis
SYVRDYNGLNT	siuuirdingelant
SYVR	seaver
SYV	seiyu
SYV	siew
SYVSMNZ	coesmans
SYVVD	seawood
SYVYRDYNGLANT	siuuirdingelant
SYVY	seavy
SYVY	seewei
SYYVAYRDYNGLNT	siuuirdingelant
SYYVNYL	sunil
SYZNHYM	sassenheim
SZARV	cessaro
TABVK	tabuk
TABYT	thabit
TAC	touch
TADR	tudor
TAD	tad
TAFT	toft
TAFTZ	tufts
TAFVN	taffone
TAGLV	tuglu
TAHARA	tahara
TAHRYHA	tahirah
TAHVN	tahoun
TAJH	taatje
TAKA	taka
TAKMN	tokman
TAKR	tucker
TAKSBRY	tuxbury
TAKV	taco
TAKY	taki
TALAN	tallan
TALBRG	thalberg
TALBVYZ	talboys
TALKVT	talcott
TALMAYR	thallmayer
TALMN	talman
TALMY	talmy
TALN	tallen
TALNV	toleno
TALS	tulse
TALVANN	tolvanen
TALYBAH	talibah
TALYS	tullis
TAMANA	tammana
TAMARA	tomura
TAMAS	tamas
TAMATYVS	tomatius
TAMAY	tamai
TAMBRVS	tombros
TAMB	thumb
TAMPAS	tampas
TAMPKYNZ	tompkins
TAMSN	thommesen
TAMSVN	thomsen
TAM	tam
TAM	thom
TAM	tom
TAMYNZ	tomines
TAMY	tomi
TAMZ	toms
TANAK	tanak
TANA	thana
TANG	tong
TANG	tongue
TANJS	tonjes
TANKN	tanneken
TANN	tunen
TANTVN	tanton
TANYS	tanis
TAPA	thapa
TAPLYN	taplin
TAPR	tupper
TAPSYN	tupshin
TAPTANY	toptani
TAPYK	topic
TAPYN	tappin
TAPYV	tapio
TARA	thara
TARDL	tardell
TARKL	turkel
TARK	tariq
TARML	turmelle
TARN	thurn
TARQ	farooq
TARS	torres
TARSVN	thorson
TAR	tarr
TARVB	tarub
TARYK	tariq
TASDYLR	tasdeler
TASKR	tasker
TATAM	tattam
TATARY	tatari
TATBAY	tatby
TATH	taatje
TATJ	taatje
TATL	title
TATL	tuttle
TATRVY	taterway
TATSVRV	tatsuro
TAT	taatje
TAT	tat
TAT	tjaatje
TATYH	taatje
TATYH	tjaatje
TATYL	tuthill
TATZ	tjaatje
TAVARS	tavares
TAVRNYNY	tavernini
TAVR	tower
TAV	tow
TAYBVT	tiebout
TAYJMN	tijmen
TAYLBRY	tilbury
TAYLMANS	tielemans
TAYLMNZ	tielemans
TAYLR	tyler
TAYLV	thilo
TAYMN	tymen
TAYNVR	tynor
TAYRAY	tierie
TAYR	thayer
TAYRVN	tyrone
TAYRY	tierie
TAYSN	tyson
TAYSVN	tyson
TAY	tai
TAYT	tytie
TAY	tye
TAYTY	tytie
TAYV	thao
TBT	thabit
TBVK	tabuk
TBYB	thabit
TBYT	thabit
TDL	thedell
TFYLAH	tafilah
TFYLA	tafilah
T'FYLH	tafilah
TGLBRG	tegelberg
TGL	tagle
THSYN	tahsin
TH	teh
THYRAH	tahirah
THYRA	tahirah
THYRH	tahirah
TJAJH	tjaatje
TJATJ	tjaatje
TKS	tex
TK	tak
TK	teche
TK	teck
TKYAH	takiyah
TKYH	takiyah
TLANDR	thelander
TLBRT	talbert
TLBVYS	talboys
TLBVYZ	talboys
TLFR	telfer
TLKVM	telecom
TLLV	tello
TLNT	tallent
TLR	teller
TL	tell
TLYBAH	talibah
TLYBA	talibah
TLYBH	talibah
TLYB	talib
TMBRY	tamburri
TMPLMN	tempelman
TMPLR	templar
TMPLTVN	templeton
TMPST	tempest
TM	tam
TMYR	tamir
TNANT	tennant
TNAYA	tenaya
TNBRVK	tenbrook
TNBV	tennebo
TNDYRY	tandiary
TNKN	tanneken
TNPV	tenpo
TNTS	tants
TNT	tent
TNVR	tanwar
TNVRYV	tenorio
TNYKN	tanneken
TNYSAN	tennyson
TNY	tinney
TPV	teppo
TQYH	takiyah
TRADA	terrada
TRAFTVN	trafton
TRAFVRD	trafford
TRAH	farah
TRAJKTNSYS	traiectensis
TRAKV	trucco
TRAN	terran
TRANYTSA	turnitsa
TRAP	trapp
TRAPYN	terrapin
TRASH	terrace
TRASTR	traster
TRA	tra
TRAVAJLYA	travaglia
TRAVN	trown
TRAVZY	trauzzi
TRAYKTNSYS	traiectensis
TRAYNTH	tryntje
TRAYNTZ	tryntje
TRAYNVR	traynor
TRAYSTNSYS	traiectensis
TRAYSTNYS	traiectensis
TRAYSY	tracy
TRAZ	taraz
TRBRY	yerbury
TRD	thurlede
TRFVRD	trafford
TRLD	thurlede
TRLDY	thurlede
TRL	terrell
TRLV	thurlo
TRMVYL	turmoil
TRMYNAL	terminal
TRNR	turner
TRNSH	terrence
TRNS	ternes
TRN	tern
TRNTN	thornton
TRNT	trent
TRNYK	ternyck
TRSA	teresa
TRS	trash
TRSTVN	threston
TRTJY	truitje
TRTJY	tryntje
TRTNH	tertene
TRTVAN	trethowan
TRTVN	turton
TRVB	tarub
TRVBY	trubey
TRVDL	trudel
TRVDSVN	troedson
TRVF	trough
TRVGTVN	troughton
TRVHYKV	teruhiko
TRVKS	truex
TRVL	teruel
TRVL	trull
TRVLYNGR	trollinger
TRVMBV	trumbo
TRVMYTR	trometer
TRVN	tron
TRVP	throop
TRVRAYS	treuerice
TRVR	terror
TRVRYK	treuerice
TRVRYS	treuerice
TRV	trough
TRVTR	trotter
TRV	true
TRVT	trout
TRVYLYGR	terwilliger
TRVYRYK	treuerice
TRVYSDYL	truesdale
TRVYTH	truitje
TRVYTJ	truitje
TRVYT	truitje
TRVYYJH	truitje
TRYBL	terrible
TRYBL	tribble
TRYDVY	treadway
TRYGS	triggs
TRYJV	torigoe
TRYK	tariq
TRYKTNSYS	traiectensis
TRYKT	trickett
TRYMSTAR	triemstra
TRYM	trim
TRYNDAD	trindade
TRYND	treindl
TRYNHAM	trainham
TRYNJH	tryntje
TRYNKL	trinkle
TRYNTH	tryntje
TRYNTJ	tryntje
TRYNT	tryntje
TRYNVR	trainor
TRYPS	tripps
TRYQ	tariq
TRYS	terris
TRYSTNSYS	traiectensis
TRYSTRM	tristram
TRYSY	tracey
TRYSY	tracy
TRY	teri
TRY	terri
TRY	terry
TRY	tierie
TRYTL	treitel
TRYTL	tritle
TRYTVRY	territory
TRYVLV	triolo
TRYVRAYS	treuerice
TRYVR	trevor
TRYVYTZ	truitje
TRZH	therese
TSKR	tasker
TSLA	tesla
TSLR	tesler
TSNR	tessner
TSTA	testa
TS	tess
TSTR	tester
TSYMA	teshima
TSYNK	tesink
TTJY	taatje
TTRAD	tetrad
TTR	tether
TTRV	tetro
TTRVYN	tetervin
TVAMA	tuama
TVARY	tewari
TVAYCL	twitchell
TVB	tobe
TVBVTYS	tubutis
TVBYAS	tobias
TVBYN	tobin
TVDAR	tudor
TVD	todd
TVFRY	tofferi
TVFTH	tufte
TVHLA	tuohela
TVKR	tucker
TVK	tooke
TVKYV	tokyo
TVLANY	tolani
TVLA	tula
TVLAY	tully
TVLDV	toledo
TVLMN	tolman
TVL	toal
TVLYN	thulin
TVLY	tooley
TVLY	tuli
TVLY	tully
TVLYVR	tolliver
TVLYV	tulio
TVMANY	tomany
TVMAS	thomas
TVMAS	tuomas
TVMATYVS	tomatius
TVMBLY	twombly
TVMS	tomes
TVM	tom
TVMY	tomi
TVMY	tommi
TVMY	tuomi
TVMYTYVS	tomatius
TVMZ	tomes
TVNAR	tonar
TVNGA	tunga
TVNG	thong
TVNG	tung
TVNG	tuong
TVNJS	tonjes
TVNR	toner
TVNS	tonjes
TVN	toon
TVNYS	teunis
TVNYS	theunis
TVNYS	tonjes
TVNY	tony
TVRAD	thorud
TVRAMBR	turambar
TVRAYA	thurayya
TVRBR	thurber
TVRDA	torda
TVRKAT	turcotte
TVRKV	turco
TVRLDH	thurlede
TVRMALA	tormala
TVRMN	thurman
TVRNBRG	tornberg
TVRNLY	thornley
TVRNR	turner
TVRN	thorn
TVRN	toren
TVRNTVN	thornton
TVRP	thorpe
TVRTL	turtle
TVRTN	thornton
TVRTVN	thornton
TVRVF	turoff
TVRVP	thorup
TVRYA	thurayya
TVRYN	turin
TVRYSN	thoresen
TVRY	torrie
TVRZ	torrez
TVSAR	tushar
TVSKANV	toscano
TVS	tooth
TVSV	tuso
TVSYNG	tusing
TVSYNK	teusink
TV	tho
TV	two
TVTY	totty
TVVYS	twiss
TVYDA	toida
TVYDY	tweedie
TVYH	tewie
TVYN	twin
TVYT	toit
TVYT	tuyet
TVYYDYL	tweedale
TVYYG	twigg
TVYYN	twin
TYBAT	tiebout
TYBL	table
TYBVT	tiebout
TYCAVR	tichauer
TYD	teed
TYF	thief
TYFVRD	tifford
TYGV	teague
TYHAN	tehan
'TYH	atiya
TYJATH	tjaatje
TYJMN	tijmen
TYLBRY	tilbury
TYLDN	tilden
TYLGNR	tilgner
TYLMANS	tielemans
TYLMNS	tielemans
TYLMNZ	tielemans
TYLN	thelen
TYLR	tiller
TYLR	tyler
TYLV	thilo
TYLVTSAN	tillotson
TYLYNG	teeling
TYMBVL	timbol
TYMKV	timko
TYMN	tijmen
TYMN	tymen
TYM	tame
TYMVNYN	timonin
TYMVR	timur
TYMYAN	timian
TYMYNZ	timmins
TYMZ	tymes
TYNANT	tennant
TYNA	tina
TYNDAL	tindall
TYNDAL	tyndall
TYNGLY	tingley
TYNG	ting
TYNG	tyng
TYNSL	tinsel
TYNSLY	tinsley
TYN	tean
TYN	tien
TYN	tin
TYNY	tiny
TYPAL	tipul
TYPV	tippu
TYRNY	tierney
TYRVKS	theroux
TYRYH	tierie
TYRY	tierie
TYRZA	tirza
TYSMNZ	tysmans
TYS	theis
TYSYNJR	tysinger
TYSZA	tisza
TY	tay
TYTAY	tytie
TYTH	tytie
TYTMAS	titmus
TYTS	tiits
TYT	tate
TYT	teeth
TYTY	tytie
TYVGA	tioga
TYVMYNN	tuominen
TYVNA	tuna
TYVNYS	teunis
TYVNYS	theunis
TYV	tio
TYYVLN	thulen
TYZ	theis
VADAPARTY	vadaparty
VADH	wade
VADRY	vawdry
VADZN	whadzen
VAFA	wafa
VAFYAH	wafiyyah
VAFYA	wafiyyah
VAGL	wagle
VAGNR	vagner
VAGNR	wagner
VAGN	vaggen
VAH	wah
VAJDYK	vajdic
VAKFYLD	wakefield
VAKRDAYN	walkerdine
VAKVRN	vankeuren
VALANS	valance
VALAS	wallace
VALDMANYVNA	waldmanneuenna
VALDMNNA	waldmanneuenna
VALDMNNYVYNA	waldmanneuenna
VALDMNYVNA	waldmanneuenna
VALDRAM	waldram
VALDV	waldo
VALDZ	valdez
VALH	walle
VALKA	walka
VALKNAR	valkenaar
VALMN	wallman
VALNTYJN	valentijn
VALNTYN	valentijn
VALN	whalen
VALRYN	valerian
VALTMN	waltman
VALTN	walton
VALTR	walter
VALTRZ	walters
VALTVN	walton
VALT	walth
VAL	vale
VAL	vall
VALVM	vollum
VALVRT	walworth
VALVR	valur
VALV	wavle
VALVYN	wallewein
VAL	wal
VALYHVR	valihora
VALYNGTN	wallington
VALYNGTVN	wallington
VALYN	wallin
VALYS	wallace
VALYS	wallis
VALY	valley
VALY	wally
VALY	whaley
VALY	whalley
VALYY	valley
VALZ	wales
VAMBVL	wombwell
VANANTVRP	vanantwerp
VANANVRP	vanantwerp
VANATVRP	vanantwerp
VANBRN	vanburen
VANBVRN	vanburen
VANDNBRQ	vandenburgh
VANDN	vanden
VANDRVYR	vanderveer
VANDRVYYR	vanderveer
VANDVSN	vandousen
VANDVZN	vanduzen
VANDYK	vandyck
VANDZN	vanduzen
VANDZVN	vanduzen
VANG	vang
VANK	vonk
VANKVRN	vancuren
VANKVRN	vankeuren
VANSCVNHVN	vanschoonhoven
VANSK	vanecek
VANSKVNHVN	vanschoonhoven
VANSY	vance
VAN	van
VANVLK	vanvleck
VANVRANKN	vanvranken
VANVRNKN	vanvranken
VAN	wan
VANZANT	vanzandt
VANZNDT	vanzandt
VARBRG	warborough
VARBRTVN	warburton
VARBRVG	warborough
VARBRVQ	warborough
VARBVRVG	warborough
VARBVRV	warborough
VARDY	vardi
VARGAS	vargas
VARGV	vargo
VARMA	varma
VARNR	warner
VARNR	werner
VARNS	varnes
VARN	warn
VARN	warne
VARNY	varney
VARTVN	wharton
VARTY	varty
VARVL	varvel
VARYANS	variants
VARYANTS	variants
VARYANTZ	variants
VARYVR	varieur
VASALV	vasallo
VASKY	waskey
VASLV	waslo
VASM	waseem
VASNGTN	washington
VASNGTVN	washington
VAST	vost
VAST	wust
VASVN	wasson
VAS	voss
VAS	wass
VASYK	wasik
VASYM	waseem
VASYNGTVN	washington
VASYT	wasit
VATANAB	watanabe
VATANYB	watanabe
VATKYNZ	watkins
VATRHAVS	waterhouse
VATRMN	waterman
VATRSVN	watterson
VATRZ	waters
VATS	watts
VATV	vato
VAT	watt
VAVDRAY	vawdry
VAVDRY	vawdry
VAYA	vaya
VAYB	wiebe
VAYBY	wiebe
VAYDMN	weidman
VAYD	wide
VAYGL	wigle
VAYLDR	wilder
VAYL	vail
VAYMN	wyman
VAYNGRV	waingrow
VAYNTH	wyntje
VAYN	vine
VAYPKJ	wiepkje
VAYSMN	wiseman
VAYS	wise
VAYTHAVS	whitehouse
VAYTHRN	whitehorn
VAYTHVRN	whitehorn
VAYTHVS	whitehouse
VAYTVRS	whitworth
VAYTYKR	whitaker
VAYTYKR	whiteaker
VAYZAK	yzaak
VAYZ	wise
VBR	weber
VBSTR	webster
VB	webb
VCNR	wechner
VDAD	widad
VDBRG	wedberg
VDLMVDY	vadlamudi
VDLYN	wedelin
VDMYR	wedemeier
VD	ved
VFA	wafa
VFYAH	wafiyyah
VFYH	wafiyyah
VFYYH	wafiyyah
VGL	vogel
VGL	vogl
VGNR	wagner
VGNR	wegner
VHRA	vohra
VJDAN	wijdan
VJYHA	wajihah
VJYHH	wajihah
VJYH	wajihah
VKKYA	voccia
VKRFAS	wackerfuss
VKRV	vaccaro
VK	wack
VLADAK	vladack
VLADAN	vladan
VLADV	vlado
VLAM	welam
VLAN	whelan
VLA	vela
VLA	vella
VLDMN	veldman
VLDMNVNA	waldmanneuenna
VLDMN	voldman
VLDN	velden
VLD	veld
VLFSVN	wolfson
VLKMAN	volkman
VLK	volk
VLK	wolke
VLMJH	wellemtje
VLMN	wellman
VLMTH	wellemtje
VLMTJ	wellemtje
VLMT	wellemtje
VLNTA	walenta
VLNTYJN	valentijn
VLNTYN	valentijn
VLR	willour
VLSKY	wolski
VLS	welsh
VLSY	wesley
VLTMR	voltmer
VLTR	welter
VLTRYNG	woltering
VLTRY	velletri
VLTY	welty
VLVDYN	volodin
VLVSV	veloso
VLYDH	walidah
VLYNGTVN	wellington
VLYNK	wellingk
VLYS	vulis
VLYS	wallace
VLZL	welzel
VLZ	volz
VLZ	wells
VNABLS	venables
VNANTVRP	vanantwerp
VNASCVNVN	vanschoonhoven
VNBRN	vanburen
VNBVRN	vanburen
VNCVNHVVN	vanschoonhoven
VNC	wench
VNDAZN	vanduzen
VNDLND	wendland
VNDL	wendel
VNDL	wendell
VNDMN	vandeman
VNDRFVRD	vanderford
VNDRVR	vanderveer
VNDRVYR	vanderveer
VNDRY	vandry
VNDVSN	vandousen
VNDVVSN	vandousen
VNDVZN	vandousen
VNDVZN	vanduzen
VND	wand
VNDYK	vandyck
VNDZL	wendzel
VNG	vang
VNHF	vanhoff
VNKATA	venkata
VNKAT	venkat
VNKRN	vancuren
VNKRN	vankeuren
VNKVRN	vancuren
VNKVRN	vankeuren
VNKV	vancko
VNKYVRN	vancuren
VNKYVRN	vankeuren
VNLK	vanvleck
VNNTVRP	vanantwerp
VNRNKN	vanvranken
VNR	venner
VNRYPR	vanriper
VNSKVNHVVN	vanschoonhoven
VNSL	wensel
VNS	vance
VNSVNHAVN	vanschoonhoven
VNSVNHVVN	vanschoonhoven
VNTRLY	ventureli
VNTZ	weintz
VN	ven
VNVLK	vanvleck
VN	von
VNVRANKN	vanvranken
VN	wan
VN	wen
VN	won
VNYK	vanick
VNYLK	vanvleck
VNYNGR	weninger
VNYRNKN	vanvranken
VNZANDT	vanzandt
VNZANT	vanzandt
VNZND	vanzandt
VNZNT	vanzandt
VRBK	verbeck
VRBVRVF	warborough
VRCYK	worchick
VRDAN	vardan
VRHVST	verhulst
VRKMN	workman
VRLV	varlow
VRLYND	verlinde
VRLYNG	worling
VRMASRN	vermaseren
VRMAS	vermaas
VRMA	verma
VRMVLN	vermeulen
VRMVNT	wermont
VRMYLYYVN	vermillion
VRMYVLN	vermeulen
VRMZ	vermes
VRNGRYN	wernegreen
VRNN	vernon
VRNR	werner
VRSVVN	wershoven
VRVBL	wrobel
VRVJH	vrouwtje
VRVTH	vrouwtje
VRVVD	whorwood
VRVVTJ	vrouwtje
VRVYJ	verweij
VRYLAV	worrilow
VRYLV	worrilow
VRYTY	verity
VRY	werry
VSAL	wisal
VSLYAN	wesleyan
VSLY	wesley
VSLZ	vessels
VSM	waseem
VSTAL	vestal
VSTFAL	westfall
VSTLY	vestli
VSTLY	westley
VSTMVRLND	westmoreland
VSTN	weston
VSTRHLM	westerholm
VSTRN	western
VSTRVLDT	westerveldt
VSTRVLT	westerveldt
VSTR	wester
VST	vest
VSTVN	weston
VSTVR	westover
VST	west
VST	weste
VS	vos
VSYM	waseem
VSYT	wasit
VSY	vessey
VSY	wasay
VTMVR	wetmore
VTR	vetter
VTR	wouter
VTS	watts
VT	wet
VVDARD	woodard
VVDBRN	woodburn
VVDD	wooded
VVDGYT	woodgate
VVDHAVS	woodhouse
VVDN	wooden
VVDRV	woodrow
VVDVARD	woodward
VVD	wood
VVGLR	vogler
VVGL	vogel
VVG	woog
VVJAK	vojak
VVK	wook
VVLARD	woolard
VVLARD	woollard
VVLMN	wolman
VVLTRNYNG	woltering
VVLY	woolley
VVLZ	vowles
VVN	woon
VVN	wun
VVRDN	worden
VVRYLAV	worrilow
VVRYLV	worrilow
VVS	voss
VVTR	wouter
VYANN	vianen
VYBH	wiebe
VYBKH	wiepkje
VYBRND	wijbrand
VYBVVV	wibowo
VYB	wiebe
VYBY	wiebe
VYCARD	witchard
VYCVRA	wichura
VYDAD	widad
VYDAL	vidal
VYDAL	widdul
VYDA	widad
VYDD	widad
VYDFANG	wildfong
VYDMAN	weidman
VYDMN	weidman
VYDMR	widmer
VYDRY	vawdry
VYDVN	weedon
VYD	wade
VYDYR	widere
VYDY	vidi
VYDYV	video
VYFAL	wifall
VYGAND	weigand
VYGAND	wiegand
VYGJYN	wiggin
VYGLY	wigley
VYGMVR	wigmore
VYGN	vigen
VYGRT	wegert
VYGSTVN	wigston
VYGTVN	wigton
VYG	weage
VYGYNZ	wiggins
VYJBRAND	wijbrand
VYJBRND	wijbrand
VYJDAN	wijdan
VYJNAND	wijnand
VYJND	weigend
VYJNND	wijnand
VYJN	wijdan
VYKAMP	weikamp
VYKAS	vikas
VYKAVN	vecoven
VYKFYLD	wakefield
VYKHAM	wickham
VYKLVND	wiklund
VYKNZ	wilkens
VYKRAM	vikram
VYKRS	vickers
VYKRZ	vickers
VYKS	weeks
VYKS	wicks
VYKTVR	victor
VYKTVR	viktor
VYKTYM	victim
VYK	vic
VYK	vik
VYK	wake
VYK	wick
VYLADVT	viladot
VYLARD	villard
VYLARD	willard
VYLASKV	velasco
VYLAS	vilas
VYLATZ	willats
VYLA	vila
VYLA	villa
VYLBR	wilber
VYLDKAT	wildcat
VYLDRMN	wilderman
VYLDYNG	wilding
VYLFRD	wilford
VYLFRD	wilfred
VYLHAYT	wilhite
VYLHLMAS	wilhelmus
VYLHLMVS	wilhelmus
VYLHLM	wilhelm
VYLJV	viljo
VYLKAKS	wilcox
VYLKANS	vilcans
VYLKAS	wilcox
VYLKNS	wilkens
VYLKN	wilken
VYLKRSVN	wilkerson
VYLKYNSN	wilkinson
VYLKYNSVN	wilkinson
VYLKYN	wilkin
VYLKYNZ	wilkins
VYLLMVS	wilhelmus
VYLMNTJY	willemintje
VYLMR	wilmer
VYLMTJY	wellemtje
VYLMT	willmot
VYLMVR	willmore
VYLMVT	wilmot
VYLMYNTH	willemintje
VYLMYNTJH	willemintje
VYLMYNTJ	willemintje
VYLMYNT	willemintje
VYLMYNYTH	willemintje
VYLND	weiland
VYLND	wieland
VYLNR	willner
VYLR	weiler
VYLR	wheeler
VYLSVN	willson
VYLS	wiles
VYL	vail
VYL	wail
VYL	will
VYLYAM	william
VYLYAMYNA	williamina
VYLYANY	villani
VYLYNGHAM	willingham
VYLYNGZ	willing
VYLYR	wheeler
VYLY	wiley
VYLY	willey
VYLY	willy
VYLZ	viles
VYLZ	wills
VYMAL	vimal
VYMAN	weimann
VYMAN	wyman
VYMBRLY	wimberley
VYMN	wyman
VYMPH	wimpje
VYMPJH	wimpje
VYMPJ	wimpje
VYMPJY	wimpje
VYMP	wimpje
VYMPYJ	wimpje
VYMR	weimar
VYNATA	vinata
VYNBRG	weinberg
VYNCSTR	winchester
VYNDN	hvinden
VYNDRZ	winders
VYNDVM	windom
VYND	wind
VYNKLMAN	winkelmann
VYNKL	winkle
VYNKLZ	winkels
VYNKV	vinko
VYNLT	weinelt
VYNND	wijnand
VYNN	whinen
VYNRT	weinert
VYNR	weiner
VYNSNT	vincent
VYNSN	wincn
VYNSR	winsor
VYNSTD	wainstead
VYNSTRVM	winstrom
VYNSTVK	weinstock
VYNSTVN	winston
VYNSVN	vinson
VYNTH	wyntje
VYNTJH	wyntje
VYNTJ	wyntje
VYNTJY	wyntje
VYNTRFYLD	winterfeld
VYNTRMYVT	wintermute
VYNTRR	winterer
VYNTR	winter
VYNTRZ	winters
VYNTVN	winton
VYNT	wyntje
VYNTZ	wyntje
VYN	vin
VYNVKR	winokur
VYN	wein
VYNYBL	venable
VYNYKY	winiecki
VYNYNGR	wininger
VYNYNGSTD	winningstad
VYNYZ	vineis
VYNZ	winz
VYPKJH	wiepkje
VYPKJ	wiepkje
VYPKJY	wiepkje
VYPK	wiepkje
VYPYN	vipin
VYRAF	viraf
VYRCVAL	virtual
VYRJYL	virgil
VYRJYNYA	virginia
VYRNDRA	virendra
VYRN	viren
VYRSMA	wiersma
VYRTANN	virtanen
VYRT	wirt
VYR	ware
VYR	weare
VYR	wier
VYRYANA	wiryana
VYRZ	weers
VYSAL	wisal
VYSKA	visca
VYSL	wisal
VYSPY	vispi
VYSR	visser
VYSR	wiser
VYSTFAL	westphal
VYSTVN	weaston
VYST	weast
VYS	vish
VYSVN	wasson
VYSVN	wesson
VYSY	veasey
VYSYVS	vicious
VYTAKA	vitaca
VYTAKR	whittaker
VYTAL	vitale
VYTFYLD	whitfield
VYTKAMB	whitcomb
VYTKVS	vaitkus
VYTMR	whitmore
VYTMVR	whittemore
VYTNBRG	whittenburg
VYTN	wheaton
VYTN	witten
VYTSH	wietse
VYTSVN	whitson
VYT	vitt
VYTVL	whitwell
VYTVR	vitor
VYTVRYA	vittoria
VYTV	vito
VYT	waite
VYT	wheat
VYT	wiebe
VYTYKR	whitaker
VYTYK	wittick
VYTYNGTVN	whittington
VYTZ	waites
VYVA	viva
VY	vee
VYVKS	vieux
VYVK	vivek
VYVLA	viola
VYVR	weaver
VYVVR	wiewer
VYVYANH	viviane
VYVYAN	vivian
VYVYK	vivek
VY	wai
VY	way
VY	wee
VYYRS	wierse
VYZBRAND	wijbrand
VYZNAND	wijnand
VYZNRY	visionary
VYZN	vizen
VYZRNR	wiserner
VYZVN	vision
VZDA	hvezda
VZYNA	vezina
XALDAH	khalidah
XALYDH	khalidah
XAN	khan
XAY	khai
XLYDA	khalidah
XLYDH	khalidah
XLYLH	kalila
XRDL	kardal
YAGLA	yagla
YAGR	yager
YAKVB	yacob
YAKVLTY	iacoletti
YAKVTAH	yakootah
YAKVTA	yakootah
YAMAHA	yamaha
YAMAHA	yamha
YAMHA	yamha
YAMN	yumn
YAMYNAH	yaminah
YAMYNA	yaminah
YANGR	younger
YANG	yang
YANGY	yangi
YANSVN	yanson
YANVVYTZ	yanowitz
YAN	yan
YANYV	yaniv
YANZK	yanzek
YAP	yap
YARGR	yerger
YARLA	iarla
YARMAN	yarman
YARVN	yaron
YARVS	yaros
YARYAN	yaryan
YASAR	yasar
YASR	yasar
YASYN	yasin
YASYRAH	yasirah
YASYRH	yasirah
YASY	yahsi
YATS	yates
YAV	yaw
YAYN	iain
YKVTAH	yakootah
YLND	yelland
YLYC	yelich
YLYF	iliff
YMHA	yamha
YMN	yumn
YMYNH	yaminah
'YN	ain
YRBRY	yerbury
YRMYS	yermish
YSRA	yasar
YSRYH	yasirah
YSYRAH	yasirah
YSYRA	yasirah
YSYRH	yasirah
YTR	yetter
YVBYRA	ubiera
YVFYNGTVN	uffington
YVHANS	johannes
YVKYLV	ukelo
YVK	yok
YVLYN	youlin
YVMANS	youmans
YVMN	yumn
YVMVRA	uemura
YVNAL	uenal
YVNAS	yonas
YVNGSAP	yongsup
YVN	iunn
YVNSVN	jonsson
YVN	yumn
YVNYZA	unaiza
YVRANYM	uranium
YVRBANYK	urbanik
YVRK	york
YVRMV	yermo
YVRYNA	urena
YVSF	yoseph
YVSTN	yousten
YVS	youse
YVSYV	yoshio
YVSY	yossi
YVSY	yossy
YVZF	yosef
YVZR	user
YYKA	yeka
YYK	yake
YYTZ	yates
YYTZ	yeats
YZAK	yzaak
YZK	yzaak
YZYD	yazid
ZABL	zabel
ZABZ	jobje
ZACARY	zachary
ZAFYNA	zafina
ZAGAR	zagar
ZAHD	zahid
ZAHYD	zahid
ZAKVB	jacobje
ZAKVB	jacques
ZAKVMYNTAY	jacomyntie
ZAKYVS	jacques
ZAK	yzaak
ZAKY	zaki
ZALAN	zalan
ZAMVR	zamore
ZAMYT	zammit
ZANGRL	zangerl
ZAN	john
ZANKH	zanneke
ZANKY	zanneke
ZANK	zanneke
ZANS	jansje
ZANT	jaantje
ZAPARA	zapara
ZARA	zara
ZARRYTN	zjarritjen
ZARVS	xaros
ZARYA	zaria
ZARYH	zaria
ZARYTN	zjarritjen
ZARYTZN	zjarritjen
ZATRVVD	zoeterwoude
ZAYNAH	zaynah
ZAYNA	zaynah
ZAYRA	zaira
ZAYR	zaira
ZAZA	zaza
ZFRY	jeffrey
ZFYNA	zafina
ZFYNH	zafina
ZHRA	jahra
ZHRA	zahirah
ZHRA	zara
ZHYD	zahid
ZHYRAH	zahirah
ZHYRA	zahirah
ZHYRH	zahirah
ZJARYTJN	zjarritjen
ZJARYTN	zjarritjen
ZKH	zeke
ZKYAH	zakiyyah
ZKYH	zakiyyah
ZKY	zaki
ZK	zec
ZK	zeke
ZLA	zella
ZLR	zeller
ZLTJ	jeltje
ZLYKAH	zuleika
ZLYXA	zuleika
ZMANK	zemanek
ZMAN	zeman
ZMYRAN	zimraan
ZMYT	zammit
ZNG	zang
ZNK	jenneke
ZNTNR	zentner
ZNYKH	zanneke
ZN	zen
ZPKA	zepka
ZRA	zara
ZRYA	zaria
ZRYFA	zarifa
ZRYF	zarifa
ZRYH	zaria
ZRYNK	zurink
ZRY	zaria
ZVHANS	johannes
ZVHANSN	johansson
ZVKA	zocca
ZVLD	zold
ZVL	joel
ZVLMR	zolmer
ZVLY	jolly
ZVLYKA	zuleika
ZVNTK	zontek
ZVRYNK	zurink
ZVRYSYKA	jurisica
ZVTRVD	zoeterwoude
ZVTRVVD	zoeterwoude
ZVVAYTA	zuvieta
ZVVYTA	zuvieta
ZVYTA	zuvieta
ZVYTRVVD	zoeterwoude
ZVZF	joseph
ZYGMVNT	zygmunt
ZYLT	gillett
ZYL	zyl
ZYMRAN	zimraan
ZYNAH	zaynah
ZYNA	zaynah
ZYNB	zainab
ZYNH	zaynah
ZYNSR	zinser
ZYRA	zaira
ZYRYLY	zirilli
ZYR	zeyer
ZYTV	zito
ZYVRYNK	zurink
ZYVTRVD	zoeterwoude
ZYZY	zeke
ZZA	zaza
ZZ	zaza
